"","fish_id","bin","LLLL","LLLR","LLRL","LLRR","LRLL","LRLR","LRRL","LRRR","RLLL","RLLR","RLRL","RLRR","RRLL","RRLR","RRRL","RRRR","L","R","total_turns","reps","alts","rel_reps","rel_alts","rel_R","rel_L"
"1","1","1",1,10,7,19,17,25,20,12,10,16,35,14,9,23,12,1,111,120,231,2,60,0.865800865800866,25.974025974026,51.9480519480519,48.0519480519481
"2","1","2",26,21,13,15,20,25,6,16,21,8,32,6,9,13,16,7,142,112,254,33,57,12.992125984252,22.4409448818898,44.0944881889764,55.9055118110236
"3","1","3",21,18,14,9,18,32,3,10,18,4,36,4,4,8,9,8,125,91,216,29,68,13.4259259259259,31.4814814814815,42.1296296296296,57.8703703703704
"4","1","4",1,7,6,5,6,27,4,9,7,4,28,8,5,9,10,21,65,92,157,22,55,14.0127388535032,35.031847133758,58.5987261146497,41.4012738853503
"5","1","5",0,3,2,2,0,16,6,6,3,1,14,10,4,8,6,1,35,47,82,1,30,1.21951219512195,36.5853658536585,57.3170731707317,42.6829268292683
"6","1","6",1,8,6,5,6,10,4,7,8,3,9,7,5,6,7,5,47,50,97,6,19,6.18556701030928,19.5876288659794,51.5463917525773,48.4536082474227
"7","10","1",0,0,1,0,1,2,1,1,0,1,2,1,1,1,1,2,6,9,15,2,4,13.3333333333333,26.6666666666667,60,40
"8","10","2",39,10,10,3,10,3,2,0,10,3,3,0,2,0,0,0,77,18,95,39,6,41.0526315789474,6.31578947368421,18.9473684210526,81.0526315789474
"9","10","3",60,6,8,0,8,2,2,0,7,2,2,1,1,1,0,0,86,14,100,60,4,60,4,14,86
"10","10","4",73,6,7,0,7,0,0,0,6,1,0,0,0,0,0,0,93,7,100,73,0,73,0,7,93
"11","10","5",73,2,2,0,2,1,0,0,2,0,1,0,0,0,0,0,80,3,83,73,2,87.9518072289157,2.40963855421687,3.6144578313253,96.3855421686747
"12","10","6",66,2,1,0,1,0,0,0,1,0,0,0,0,0,0,0,70,1,71,66,0,92.9577464788732,0,1.40845070422535,98.5915492957746
"13","11","1",33,3,2,1,2,0,1,0,4,0,0,0,2,0,0,0,42,6,48,33,0,68.75,0,12.5,87.5
"14","11","2",51,1,0,1,0,0,1,0,1,0,0,0,1,0,0,0,54,2,56,51,0,91.0714285714286,0,3.57142857142857,96.4285714285714
"15","11","3",52,0,0,0,0,0,0,0,0,0,0,0,0,0,0,0,52,0,52,52,0,100,0,0,100
"16","11","4",29,1,1,0,1,0,0,0,1,0,0,0,0,0,0,0,32,1,33,29,0,87.8787878787879,0,3.03030303030303,96.969696969697
"17","11","5",22,0,0,0,0,0,0,0,0,0,0,0,0,0,0,0,22,0,22,22,0,100,0,0,100
"18","11","6",25,1,1,0,1,0,0,0,0,0,0,0,0,0,0,0,28,0,28,25,0,89.2857142857143,0,0,100
"19","12","1",41,5,5,2,6,1,2,0,5,3,2,0,1,1,0,0,62,12,74,41,3,55.4054054054054,4.05405405405405,16.2162162162162,83.7837837837838
"20","12","2",32,6,7,2,7,4,2,1,6,2,4,2,1,2,1,0,61,18,79,32,8,40.5063291139241,10.126582278481,22.7848101265823,77.2151898734177
"21","12","3",31,8,9,1,9,1,2,1,8,3,1,1,2,1,1,0,62,17,79,31,2,39.2405063291139,2.53164556962025,21.5189873417722,78.4810126582279
"22","12","4",1,1,1,2,1,5,1,6,1,1,5,5,1,6,6,35,18,60,78,36,10,46.1538461538462,12.8205128205128,76.9230769230769,23.0769230769231
"23","12","5",1,1,2,0,0,7,0,8,1,1,6,8,2,6,8,24,19,56,75,25,13,33.3333333333333,17.3333333333333,74.6666666666667,25.3333333333333
"24","12","6",0,1,0,3,1,3,3,3,1,3,3,3,3,3,3,5,14,24,38,5,6,13.1578947368421,15.7894736842105,63.1578947368421,36.8421052631579
"25","13","1",12,4,4,3,3,2,7,6,4,2,1,10,3,9,6,7,41,42,83,19,3,22.8915662650602,3.6144578313253,50.6024096385542,49.3975903614458
"26","13","2",0,0,1,0,0,3,2,9,0,1,2,11,1,10,8,25,15,58,73,25,5,34.2465753424658,6.84931506849315,79.4520547945205,20.5479452054795
"27","13","3",0,1,4,1,3,7,1,2,1,4,7,2,2,2,3,12,19,33,52,12,14,23.0769230769231,26.9230769230769,63.4615384615385,36.5384615384615
"28","13","4",1,1,0,1,1,1,1,1,1,0,1,1,0,1,0,0,7,4,11,1,2,9.09090909090909,18.1818181818182,36.3636363636364,63.6363636363636
"29","13","5",0,0,0,0,0,0,1,0,0,0,0,1,0,1,1,1,1,4,5,1,0,20,0,80,20
"30","13","6",0,0,0,0,0,0,0,0,0,0,0,1,0,1,0,0,0,2,2,0,0,0,0,100,0
"31","14","1",0,0,0,0,1,0,1,0,0,0,1,0,0,1,0,0,2,2,4,0,1,0,25,50,50
"32","14","2",0,0,0,0,0,0,0,0,0,0,0,0,0,0,0,0,0,0,0,0,0,NA,NA,NA,NA
"33","14","3",0,0,0,0,0,0,0,0,0,0,0,0,0,0,0,0,0,0,0,0,0,NA,NA,NA,NA
"34","14","4",0,0,1,0,0,2,0,2,0,1,1,2,0,1,1,0,5,6,11,0,3,0,27.2727272727273,54.5454545454545,45.4545454545455
"35","14","5",0,0,0,0,0,0,0,0,0,0,0,0,1,0,1,1,0,3,3,1,0,33.3333333333333,0,100,0
"36","14","6",0,0,0,0,0,0,0,0,0,0,0,0,0,0,0,0,0,0,0,0,0,NA,NA,NA,NA
"37","15","1",2,0,0,0,1,0,0,0,1,0,1,0,0,0,0,0,3,2,5,2,1,40,20,40,60
"38","15","2",1,0,0,0,0,0,0,0,0,0,0,0,0,0,0,0,1,0,1,1,0,100,0,0,100
"39","15","3",0,1,0,0,0,0,0,0,0,0,0,0,0,0,0,0,1,0,1,0,0,0,0,0,100
"40","15","4",0,0,1,0,1,0,0,0,0,0,0,0,0,0,0,0,2,0,2,0,0,0,0,0,100
"41","15","5",0,0,1,0,0,1,0,0,0,1,0,0,0,0,0,0,2,1,3,0,1,0,33.3333333333333,33.3333333333333,66.6666666666667
"42","15","6",5,6,6,3,6,10,2,2,6,3,10,1,3,1,2,0,40,26,66,5,20,7.57575757575758,30.3030303030303,39.3939393939394,60.6060606060606
"43","16","1",16,3,4,2,5,7,1,2,3,3,9,1,1,2,2,1,40,22,62,17,16,27.4193548387097,25.8064516129032,35.4838709677419,64.5161290322581
"44","16","2",0,0,0,0,0,0,0,0,0,0,0,0,0,0,0,0,0,0,0,0,0,NA,NA,NA,NA
"45","16","3",0,0,0,0,0,1,1,0,0,0,0,1,0,0,0,0,2,1,3,0,1,0,33.3333333333333,33.3333333333333,66.6666666666667
"46","16","4",0,0,0,0,0,0,0,0,0,0,0,0,0,1,0,0,0,1,1,0,0,0,0,100,0
"47","16","5",0,0,0,0,0,0,0,1,0,0,0,1,0,1,1,0,1,3,4,0,0,0,0,75,25
"48","16","6",1,2,2,0,1,22,1,1,2,1,21,2,2,0,1,1,30,30,60,2,43,3.33333333333333,71.6666666666667,50,50
"49","17","1",76,7,6,2,6,0,2,0,8,0,0,0,2,0,0,0,99,10,109,76,0,69.7247706422018,0,9.1743119266055,90.8256880733945
"50","17","2",165,1,1,0,1,0,0,0,1,0,0,0,0,0,0,0,168,1,169,165,0,97.6331360946746,0,0.591715976331361,99.4082840236686
"51","17","3",145,2,2,0,2,0,0,0,2,0,0,0,0,0,0,0,151,2,153,145,0,94.7712418300654,0,1.30718954248366,98.6928104575163
"52","17","4",145,0,0,0,0,0,0,0,0,0,0,0,0,0,0,0,145,0,145,145,0,100,0,0,100
"53","17","5",125,2,2,0,2,0,0,0,2,0,0,0,0,0,0,0,131,2,133,125,0,93.984962406015,0,1.50375939849624,98.4962406015038
"54","17","6",105,0,0,0,0,0,0,0,0,0,0,0,0,0,0,0,105,0,105,105,0,100,0,0,100
"55","18","1",30,9,10,2,9,6,4,0,8,4,5,2,3,1,0,0,70,23,93,30,11,32.258064516129,11.8279569892473,24.7311827956989,75.2688172043011
"56","18","2",48,12,13,2,12,4,2,0,12,2,4,0,2,0,0,0,93,20,113,48,8,42.4778761061947,7.07964601769912,17.6991150442478,82.3008849557522
"57","18","3",28,9,9,1,9,13,2,0,9,1,12,1,2,0,0,0,71,25,96,28,25,29.1666666666667,26.0416666666667,26.0416666666667,73.9583333333333
"58","18","4",25,9,11,1,11,3,2,0,10,3,3,1,1,1,0,0,62,19,81,25,6,30.8641975308642,7.40740740740741,23.4567901234568,76.5432098765432
"59","18","5",29,10,10,2,10,1,2,0,9,2,2,0,1,1,0,0,64,15,79,29,3,36.7088607594937,3.79746835443038,18.9873417721519,81.0126582278481
"60","18","6",31,8,5,3,7,2,1,1,8,0,3,0,1,1,1,0,58,14,72,31,5,43.0555555555556,6.94444444444444,19.4444444444444,80.5555555555556
"61","19","1",0,1,1,1,1,3,2,5,1,1,3,6,0,6,5,6,14,28,42,6,6,14.2857142857143,14.2857142857143,66.6666666666667,33.3333333333333
"62","19","2",7,1,0,0,0,6,1,3,1,0,6,4,1,4,3,3,18,22,40,10,12,25,30,55,45
"63","19","3",1,1,2,3,1,3,3,1,1,3,2,1,3,0,1,1,15,12,27,2,5,7.40740740740741,18.5185185185185,44.4444444444444,55.5555555555556
"64","19","4",9,3,3,1,3,0,1,0,3,1,1,0,1,1,0,0,20,7,27,9,1,33.3333333333333,3.7037037037037,25.9259259259259,74.0740740740741
"65","19","5",6,1,2,1,3,1,1,0,1,2,2,0,0,1,0,0,15,6,21,6,3,28.5714285714286,14.2857142857143,28.5714285714286,71.4285714285714
"66","19","6",4,2,1,2,2,0,0,2,2,1,0,0,1,0,1,0,13,5,18,4,0,22.2222222222222,0,27.7777777777778,72.2222222222222
"67","2","1",12,6,7,7,5,10,15,6,6,7,8,14,8,13,6,8,68,70,138,20,18,14.4927536231884,13.0434782608696,50.7246376811594,49.2753623188406
"68","2","2",3,8,7,13,7,11,12,7,8,13,11,6,14,5,7,7,68,71,139,10,22,7.19424460431655,15.8273381294964,51.0791366906475,48.9208633093525
"69","2","3",2,3,3,7,5,9,11,4,3,6,11,8,5,10,4,5,44,52,96,7,20,7.29166666666667,20.8333333333333,54.1666666666667,45.8333333333333
"70","2","4",1,2,3,2,3,14,3,2,2,3,15,3,1,4,2,1,30,31,61,2,29,3.27868852459016,47.5409836065574,50.8196721311475,49.1803278688525
"71","2","5",3,2,2,5,3,4,6,2,2,5,4,3,5,3,2,0,27,24,51,3,8,5.88235294117647,15.6862745098039,47.0588235294118,52.9411764705882
"72","2","6",0,1,0,3,1,20,4,1,1,2,21,2,1,3,0,0,30,30,60,0,41,0,68.3333333333333,50,50
"73","20","1",8,4,3,7,1,5,4,10,4,6,3,7,9,5,11,5,42,50,92,13,8,14.1304347826087,8.69565217391304,54.3478260869565,45.6521739130435
"74","20","2",4,3,4,6,3,2,4,8,3,7,1,6,7,5,7,20,34,56,90,24,3,26.6666666666667,3.33333333333333,62.2222222222222,37.7777777777778
"75","20","3",1,0,0,0,1,3,2,2,1,0,4,4,0,5,3,4,9,21,30,5,7,16.6666666666667,23.3333333333333,70,30
"76","20","4",0,0,0,0,0,0,0,0,0,0,0,0,0,0,0,0,0,0,0,0,0,NA,NA,NA,NA
"77","20","5",0,0,0,0,0,0,0,0,0,0,0,0,0,0,0,0,0,0,0,0,0,NA,NA,NA,NA
"78","20","6",1,1,2,1,0,3,1,1,0,2,2,1,2,0,1,1,10,9,19,2,5,10.5263157894737,26.3157894736842,47.3684210526316,52.6315789473684
"79","21","1",0,0,1,3,3,5,4,1,0,4,7,2,1,4,1,1,17,20,37,1,12,2.7027027027027,32.4324324324324,54.0540540540541,45.9459459459459
"80","21","2",1,1,0,1,0,0,2,0,1,0,0,0,1,0,0,0,5,2,7,1,0,14.2857142857143,0,28.5714285714286,71.4285714285714
"81","21","3",0,0,0,0,0,0,0,0,1,0,0,0,1,0,0,0,0,2,2,0,0,0,0,100,0
"82","21","4",0,0,0,0,0,0,0,0,0,0,0,0,0,0,0,0,0,0,0,0,0,NA,NA,NA,NA
"83","21","5",0,0,0,0,0,0,0,0,0,0,0,0,0,0,0,0,0,0,0,0,0,NA,NA,NA,NA
"84","21","6",0,0,0,0,0,0,0,0,0,0,0,0,0,0,0,0,0,0,0,0,0,NA,NA,NA,NA
"85","22","1",0,1,0,1,0,0,1,0,0,0,0,0,0,0,0,0,3,0,3,0,0,0,0,0,100
"86","22","2",0,0,0,0,0,0,0,0,0,0,0,0,0,0,0,0,0,0,0,0,0,NA,NA,NA,NA
"87","22","3",0,0,0,0,0,0,0,0,0,0,0,0,0,0,0,0,0,0,0,0,0,NA,NA,NA,NA
"88","22","4",0,0,0,0,0,0,0,0,0,0,0,0,0,0,0,0,0,0,0,0,0,NA,NA,NA,NA
"89","22","5",0,0,0,0,0,0,0,0,0,0,0,0,0,0,0,0,0,0,0,0,0,NA,NA,NA,NA
"90","22","6",0,0,0,0,0,0,0,0,0,0,0,0,0,0,0,0,0,0,0,0,0,NA,NA,NA,NA
"91","23","1",4,6,7,5,5,18,8,4,6,6,16,7,7,5,3,5,57,55,112,9,34,8.03571428571429,30.3571428571429,49.1071428571429,50.8928571428571
"92","23","2",2,2,4,6,5,10,7,6,2,8,11,8,5,9,7,15,42,65,107,17,21,15.8878504672897,19.6261682242991,60.7476635514019,39.2523364485981
"93","23","3",0,0,0,1,1,21,3,6,0,1,22,7,0,9,6,3,32,48,80,3,43,3.75,53.75,60,40
"94","23","4",0,0,1,2,3,14,1,4,0,3,16,3,0,5,4,9,25,40,65,9,30,13.8461538461538,46.1538461538462,61.5384615384615,38.4615384615385
"95","23","5",0,2,3,3,4,2,3,1,2,4,3,2,2,2,1,2,18,18,36,2,5,5.55555555555556,13.8888888888889,50,50
"96","23","6",1,1,2,1,2,3,3,1,1,2,3,3,1,3,1,1,14,15,29,2,6,6.89655172413793,20.6896551724138,51.7241379310345,48.2758620689655
"97","24","1",17,2,2,2,2,1,2,1,2,2,1,0,2,0,1,1,29,9,38,18,2,47.3684210526316,5.26315789473684,23.6842105263158,76.3157894736842
"98","24","2",0,0,0,0,0,0,1,0,0,0,0,1,0,2,0,0,1,3,4,0,0,0,0,75,25
"99","24","3",0,0,0,0,0,0,0,0,0,0,0,0,0,0,0,0,0,0,0,0,0,NA,NA,NA,NA
"100","24","4",0,0,0,0,0,0,0,0,0,0,0,0,0,0,0,0,0,0,0,0,0,NA,NA,NA,NA
"101","24","5",0,0,0,0,0,0,0,0,0,0,0,0,0,0,0,0,0,0,0,0,0,NA,NA,NA,NA
"102","24","6",0,0,0,0,0,0,0,0,0,0,0,0,0,0,0,0,0,0,0,0,0,NA,NA,NA,NA
"103","25","1",13,6,10,6,12,10,7,1,6,11,11,2,5,3,1,1,65,40,105,14,21,13.3333333333333,20,38.0952380952381,61.9047619047619
"104","25","2",7,4,11,2,10,37,9,2,4,8,37,9,2,9,2,1,82,72,154,8,74,5.19480519480519,48.0519480519481,46.7532467532468,53.2467532467532
"105","25","3",0,2,7,2,2,47,8,7,2,7,41,13,7,8,7,7,75,92,167,7,88,4.19161676646707,52.6946107784431,55.0898203592814,44.9101796407186
"106","25","4",1,1,4,2,2,41,4,14,1,5,39,16,4,13,13,17,69,108,177,18,80,10.1694915254237,45.1977401129944,61.0169491525424,38.9830508474576
"107","25","5",0,1,3,6,2,20,7,13,1,8,19,14,7,13,13,43,52,118,170,43,39,25.2941176470588,22.9411764705882,69.4117647058823,30.5882352941176
"108","25","6",4,3,1,8,0,6,2,12,3,6,5,6,9,6,13,88,36,136,172,92,11,53.4883720930233,6.3953488372093,79.0697674418605,20.9302325581395
"109","26","1",0,1,1,0,1,1,0,1,1,0,1,1,0,0,1,1,5,5,10,1,2,10,20,50,50
"110","26","2",8,4,5,0,5,1,1,0,5,1,1,1,1,1,0,0,24,10,34,8,2,23.5294117647059,5.88235294117647,29.4117647058824,70.5882352941177
"111","26","3",57,13,12,2,12,1,2,0,12,1,1,0,2,0,0,0,99,16,115,57,2,49.5652173913044,1.73913043478261,13.9130434782609,86.0869565217391
"112","26","4",48,12,18,4,17,8,5,1,12,10,7,2,4,2,1,0,113,38,151,48,15,31.7880794701987,9.93377483443709,25.1655629139073,74.8344370860927
"113","26","5",59,7,7,1,7,4,2,0,8,1,4,1,2,0,0,0,87,16,103,59,8,57.2815533980583,7.76699029126214,15.5339805825243,84.4660194174757
"114","26","6",72,5,5,0,4,3,0,0,4,0,2,0,0,0,0,0,89,6,95,72,5,75.7894736842105,5.26315789473684,6.31578947368421,93.6842105263158
"115","27","1",1,5,6,4,7,10,2,9,5,5,11,7,3,7,8,14,44,60,104,15,21,14.4230769230769,20.1923076923077,57.6923076923077,42.3076923076923
"116","27","2",4,5,6,3,7,4,3,2,6,4,5,2,3,3,3,7,34,33,67,11,9,16.4179104477612,13.4328358208955,49.2537313432836,50.7462686567164
"117","27","3",2,4,6,4,5,2,5,5,3,6,1,6,4,5,4,8,33,37,70,10,3,14.2857142857143,4.28571428571429,52.8571428571429,47.1428571428571
"118","27","4",0,1,4,1,4,3,1,2,1,4,3,3,1,3,3,4,16,22,38,4,6,10.5263157894737,15.7894736842105,57.8947368421053,42.1052631578947
"119","27","5",2,1,3,0,1,4,3,2,2,2,2,4,3,2,2,2,16,19,35,4,6,11.4285714285714,17.1428571428571,54.2857142857143,45.7142857142857
"120","27","6",2,2,3,2,3,1,3,2,1,4,1,3,2,3,2,2,18,18,36,4,2,11.1111111111111,5.55555555555556,50,50
"121","28","1",0,1,0,2,1,0,1,1,1,0,1,0,0,1,1,1,6,5,11,1,1,9.09090909090909,9.09090909090909,45.4545454545455,54.5454545454545
"122","28","2",0,0,0,0,0,0,0,0,1,0,0,0,1,0,0,0,0,2,2,0,0,0,0,100,0
"123","28","3",1,0,0,0,0,0,0,0,0,0,0,0,0,0,0,0,1,0,1,1,0,100,0,0,100
"124","28","4",3,1,0,1,0,0,0,0,0,0,0,0,0,0,0,0,5,0,5,3,0,60,0,0,100
"125","28","5",0,0,0,0,0,0,0,1,0,0,0,0,0,0,1,0,1,1,2,0,0,0,0,50,50
"126","28","6",0,0,0,0,0,0,0,0,0,0,0,0,0,0,0,0,0,0,0,0,0,NA,NA,NA,NA
"127","29","1",0,3,4,5,2,14,7,7,3,7,12,9,8,6,7,4,42,56,98,4,26,4.08163265306122,26.530612244898,57.1428571428571,42.8571428571429
"128","29","2",1,3,1,7,1,3,9,12,3,5,3,14,7,14,12,8,37,66,103,9,6,8.7378640776699,5.8252427184466,64.0776699029126,35.9223300970874
"129","29","3",0,0,2,1,0,5,2,8,0,2,3,9,2,7,7,23,18,53,71,23,8,32.3943661971831,11.2676056338028,74.6478873239437,25.3521126760563
"130","29","4",1,3,2,2,3,4,6,0,3,2,5,4,2,5,1,5,21,27,48,6,9,12.5,18.75,56.25,43.75
"131","29","5",1,1,1,1,1,2,2,3,1,0,2,4,0,4,2,5,12,18,30,6,4,20,13.3333333333333,60,40
"132","29","6",0,0,0,0,0,0,0,1,0,0,1,1,0,2,2,22,1,28,29,22,1,75.8620689655172,3.44827586206897,96.551724137931,3.44827586206897
"133","3","1",0,0,0,0,0,0,0,6,0,0,0,6,0,6,6,59,6,77,83,59,0,71.0843373493976,0,92.7710843373494,7.2289156626506
"134","3","2",0,1,0,2,0,0,1,9,1,1,0,8,2,8,9,42,13,71,84,42,0,50,0,84.5238095238095,15.4761904761905
"135","3","3",0,0,0,1,0,0,0,5,0,1,0,4,1,4,5,53,6,68,74,53,0,71.6216216216216,0,91.8918918918919,8.10810810810811
"136","3","4",0,0,1,0,0,1,1,5,0,1,0,6,1,5,5,50,8,68,76,50,1,65.7894736842105,1.31578947368421,89.4736842105263,10.5263157894737
"137","3","5",0,0,0,0,0,0,0,2,0,0,0,2,0,2,2,62,2,68,70,62,0,88.5714285714286,0,97.1428571428571,2.85714285714286
"138","3","6",0,0,0,1,0,0,0,1,0,2,0,0,2,0,2,50,2,56,58,50,0,86.2068965517241,0,96.551724137931,3.44827586206897
"139","30","1",0,0,0,0,0,0,0,0,0,0,0,0,0,0,0,0,0,0,0,0,0,NA,NA,NA,NA
"140","30","2",0,0,0,0,0,1,0,0,0,0,0,1,0,0,0,0,1,1,2,0,1,0,50,50,50
"141","30","3",0,0,0,0,0,0,0,0,0,0,0,0,0,0,0,0,0,0,0,0,0,NA,NA,NA,NA
"142","30","4",0,0,0,0,0,0,0,0,0,0,0,0,0,0,0,0,0,0,0,0,0,NA,NA,NA,NA
"143","30","5",0,0,0,0,0,0,0,0,0,0,0,0,0,0,0,0,0,0,0,0,0,NA,NA,NA,NA
"144","30","6",0,0,0,0,0,0,1,0,0,0,0,0,0,1,0,0,1,1,2,0,0,0,0,50,50
"145","31","1",1,0,0,0,0,0,0,0,1,0,0,0,1,0,0,0,1,2,3,1,0,33.3333333333333,0,66.6666666666667,33.3333333333333
"146","31","2",0,0,0,0,0,0,0,0,0,0,0,0,0,0,0,0,0,0,0,0,0,NA,NA,NA,NA
"147","31","3",0,0,0,0,0,0,0,0,0,0,0,0,0,0,0,0,0,0,0,0,0,NA,NA,NA,NA
"148","31","4",0,0,0,0,0,0,0,0,0,0,0,0,0,0,0,0,0,0,0,0,0,NA,NA,NA,NA
"149","31","5",1,0,0,0,0,0,0,0,0,0,0,0,0,0,0,0,1,0,1,1,0,100,0,0,100
"150","31","6",5,1,1,0,1,0,0,0,0,0,0,0,0,0,0,0,8,0,8,5,0,62.5,0,0,100
"151","32","1",85,6,7,5,6,4,7,2,7,6,3,4,6,3,2,5,122,36,158,90,7,56.9620253164557,4.43037974683544,22.7848101265823,77.2151898734177
"152","32","2",118,5,5,0,5,1,0,0,5,0,1,0,0,0,0,0,134,6,140,118,2,84.2857142857143,1.42857142857143,4.28571428571429,95.7142857142857
"153","32","3",111,8,6,2,7,0,2,0,8,0,1,0,1,1,0,0,136,11,147,111,1,75.5102040816327,0.680272108843537,7.48299319727891,92.5170068027211
"154","32","4",109,7,6,1,5,4,2,1,7,0,3,2,2,1,1,0,135,16,151,109,7,72.1854304635762,4.63576158940397,10.5960264900662,89.4039735099338
"155","32","5",109,7,8,1,8,2,2,0,7,2,2,1,1,1,0,0,137,14,151,109,4,72.1854304635762,2.64900662251656,9.27152317880795,90.728476821192
"156","32","6",157,4,4,0,3,1,0,0,3,0,0,0,0,0,0,0,169,3,172,157,1,91.2790697674419,0.581395348837209,1.74418604651163,98.2558139534884
"157","33","1",0,0,0,0,1,0,0,0,1,0,1,0,0,0,0,0,1,2,3,0,1,0,33.3333333333333,66.6666666666667,33.3333333333333
"158","33","2",2,1,0,1,0,0,0,1,0,0,0,0,0,0,0,0,5,0,5,2,0,40,0,0,100
"159","33","3",0,0,0,0,0,0,0,0,0,0,0,0,0,0,0,0,0,0,0,0,0,NA,NA,NA,NA
"160","33","4",0,0,0,0,0,0,0,0,0,0,0,0,0,0,0,0,0,0,0,0,0,NA,NA,NA,NA
"161","33","5",0,0,0,0,0,0,0,0,0,0,0,0,0,0,0,1,0,1,1,1,0,100,0,100,0
"162","33","6",0,0,0,0,0,0,0,0,0,0,0,0,0,0,0,0,0,0,0,0,0,NA,NA,NA,NA
"163","34","1",0,0,0,0,0,1,0,0,0,0,2,0,0,1,1,5,1,9,10,5,3,50,30,90,10
"164","34","2",0,0,0,0,0,0,0,0,0,0,0,0,0,0,0,0,0,0,0,0,0,NA,NA,NA,NA
"165","34","3",10,1,1,1,1,1,2,1,2,1,0,2,2,1,1,0,18,9,27,10,1,37.037037037037,3.7037037037037,33.3333333333333,66.6666666666667
"166","34","4",39,5,6,0,4,2,2,0,4,1,0,2,1,1,0,0,58,9,67,39,2,58.2089552238806,2.98507462686567,13.4328358208955,86.5671641791045
"167","34","5",40,3,2,1,2,0,1,1,4,0,0,1,2,0,1,15,50,23,73,55,0,75.3424657534247,0,31.5068493150685,68.4931506849315
"168","34","6",19,1,1,0,1,0,0,0,0,1,0,0,0,0,0,0,22,1,23,19,0,82.6086956521739,0,4.34782608695652,95.6521739130435
"169","35","1",0,1,2,0,3,49,1,2,1,1,50,3,0,3,2,1,58,61,119,1,99,0.840336134453782,83.1932773109244,51.2605042016807,48.7394957983193
"170","35","2",2,3,5,1,3,8,3,0,3,3,6,2,2,1,0,0,25,17,42,2,14,4.76190476190476,33.3333333333333,40.4761904761905,59.5238095238095
"171","35","3",5,4,6,2,7,11,4,0,4,4,13,2,1,3,0,0,39,27,66,5,24,7.57575757575758,36.3636363636364,40.9090909090909,59.0909090909091
"172","35","4",5,2,2,0,3,0,0,0,3,0,0,0,0,0,0,0,12,3,15,5,0,33.3333333333333,0,20,80
"173","35","5",4,5,6,0,5,11,0,0,4,1,11,0,0,0,0,0,31,16,47,4,22,8.51063829787234,46.8085106382979,34.0425531914894,65.9574468085106
"174","35","6",7,5,7,0,8,5,1,0,6,2,5,1,0,1,0,0,33,15,48,7,10,14.5833333333333,20.8333333333333,31.25,68.75
"175","36","1",16,4,6,3,6,4,2,2,3,5,4,1,3,1,2,8,43,27,70,24,8,34.2857142857143,11.4285714285714,38.5714285714286,61.4285714285714
"176","36","2",1,5,5,7,5,3,4,4,5,7,3,2,6,2,4,7,34,36,70,8,6,11.4285714285714,8.57142857142857,51.4285714285714,48.5714285714286
"177","36","3",3,3,3,4,3,5,4,5,3,4,5,5,4,5,5,7,30,38,68,10,10,14.7058823529412,14.7058823529412,55.8823529411765,44.1176470588235
"178","36","4",13,2,3,2,5,1,2,3,3,3,3,2,1,4,3,6,31,25,56,19,4,33.9285714285714,7.14285714285714,44.6428571428571,55.3571428571429
"179","36","5",9,2,2,0,2,0,0,0,2,0,0,0,0,0,0,0,15,2,17,9,0,52.9411764705882,0,11.7647058823529,88.2352941176471
"180","36","6",6,2,1,1,1,0,1,0,1,0,0,0,0,0,0,0,12,1,13,6,0,46.1538461538462,0,7.69230769230769,92.3076923076923
"181","37","1",1,0,0,0,0,0,0,0,1,0,0,0,1,0,0,0,1,2,3,1,0,33.3333333333333,0,66.6666666666667,33.3333333333333
"182","37","2",0,0,0,0,0,0,0,0,0,0,0,0,0,0,0,0,0,0,0,0,0,NA,NA,NA,NA
"183","37","3",0,1,1,0,0,0,0,0,0,0,0,0,0,0,0,0,2,0,2,0,0,0,0,0,100
"184","37","4",0,0,0,0,0,0,0,0,0,0,0,0,0,0,0,0,0,0,0,0,0,NA,NA,NA,NA
"185","37","5",0,0,0,0,0,0,0,0,0,0,0,0,0,0,0,0,0,0,0,0,0,NA,NA,NA,NA
"186","37","6",0,0,0,0,0,0,0,0,0,0,0,0,0,0,0,0,0,0,0,0,0,NA,NA,NA,NA
"187","38","1",1,1,4,3,3,9,4,3,1,6,7,4,4,2,2,3,28,29,57,4,16,7.01754385964912,28.0701754385965,50.8771929824561,49.1228070175439
"188","38","2",8,7,7,3,6,3,4,5,7,3,2,7,4,6,6,10,43,45,88,18,5,20.4545454545455,5.68181818181818,51.1363636363636,48.8636363636364
"189","38","3",2,4,1,5,1,3,6,8,4,2,3,8,5,8,7,24,30,61,91,26,6,28.5714285714286,6.59340659340659,67.032967032967,32.967032967033
"190","38","4",0,0,1,3,1,0,1,6,0,4,0,5,3,5,7,40,12,64,76,40,0,52.6315789473684,0,84.2105263157895,15.7894736842105
"191","38","5",0,0,1,1,0,3,1,7,0,2,2,6,2,6,7,33,13,58,71,33,5,46.4788732394366,7.04225352112676,81.6901408450704,18.3098591549296
"192","38","6",1,0,1,0,1,2,2,6,1,1,2,8,1,7,6,22,13,48,61,23,4,37.7049180327869,6.55737704918033,78.6885245901639,21.3114754098361
"193","39","1",3,1,2,0,1,1,0,0,1,0,0,0,0,0,0,0,8,1,9,3,1,33.3333333333333,11.1111111111111,11.1111111111111,88.8888888888889
"194","39","2",0,0,0,0,0,0,0,0,0,0,1,0,0,0,0,0,0,1,1,0,1,0,100,100,0
"195","39","3",0,0,0,0,0,0,0,0,0,0,0,0,0,0,0,0,0,0,0,0,0,NA,NA,NA,NA
"196","39","4",0,0,0,0,0,0,0,0,0,0,0,0,0,0,0,0,0,0,0,0,0,NA,NA,NA,NA
"197","39","5",0,0,0,0,0,0,0,0,0,0,0,0,0,0,0,0,0,0,0,0,0,NA,NA,NA,NA
"198","39","6",0,0,0,0,0,0,0,0,0,0,0,0,0,0,0,0,0,0,0,0,0,NA,NA,NA,NA
"199","4","1",1,0,1,0,1,1,0,0,1,0,1,0,0,0,0,0,4,2,6,1,2,16.6666666666667,33.3333333333333,33.3333333333333,66.6666666666667
"200","4","2",3,0,0,0,0,0,0,0,0,0,0,0,0,0,0,0,3,0,3,3,0,100,0,0,100
"201","4","3",1,0,0,0,0,0,0,0,0,0,0,0,0,0,0,0,1,0,1,1,0,100,0,0,100
"202","4","4",1,1,1,0,0,0,0,0,0,0,0,0,0,0,0,0,3,0,3,1,0,33.3333333333333,0,0,100
"203","4","5",1,1,0,0,1,0,0,0,1,0,0,0,0,0,0,0,3,1,4,1,0,25,0,25,75
"204","4","6",0,0,1,0,0,0,0,0,0,0,0,0,0,0,0,0,1,0,1,0,0,0,0,0,100
"205","40","1",0,1,1,0,0,17,3,8,1,0,15,11,1,10,8,13,30,59,89,13,32,14.6067415730337,35.9550561797753,66.2921348314607,33.7078651685393
"206","40","2",0,1,1,1,0,3,3,5,1,1,2,7,2,5,5,20,14,43,57,20,5,35.0877192982456,8.7719298245614,75.4385964912281,24.5614035087719
"207","40","3",0,0,0,0,0,4,0,4,0,0,4,4,0,4,3,9,8,24,32,9,8,28.125,25,75,25
"208","40","4",0,0,1,0,0,23,1,1,0,1,22,2,1,2,2,5,26,35,61,5,45,8.19672131147541,73.7704918032787,57.3770491803279,42.6229508196721
"209","40","5",0,0,0,0,0,15,0,1,0,0,16,1,0,1,1,1,16,20,36,1,31,2.77777777777778,86.1111111111111,55.5555555555556,44.4444444444444
"210","40","6",0,0,2,0,2,14,1,1,0,2,14,2,0,2,1,1,20,22,42,1,28,2.38095238095238,66.6666666666667,52.3809523809524,47.6190476190476
"211","41","1",4,1,0,0,0,1,0,1,1,0,0,1,1,0,1,2,7,6,13,6,1,46.1538461538462,7.69230769230769,46.1538461538462,53.8461538461538
"212","41","2",0,1,1,1,1,6,1,4,1,0,6,4,0,4,3,1,15,19,34,1,12,2.94117647058824,35.2941176470588,55.8823529411765,44.1176470588235
"213","41","3",0,1,2,2,1,17,2,3,1,3,17,3,3,3,4,10,28,44,72,10,34,13.8888888888889,47.2222222222222,61.1111111111111,38.8888888888889
"214","41","4",4,2,2,2,4,8,1,4,2,2,9,3,1,4,4,5,27,30,57,9,17,15.7894736842105,29.8245614035088,52.6315789473684,47.3684210526316
"215","41","5",0,0,1,1,0,1,2,4,0,2,0,5,1,5,4,16,9,33,42,16,1,38.0952380952381,2.38095238095238,78.5714285714286,21.4285714285714
"216","41","6",0,0,0,0,0,1,0,2,0,0,1,2,0,1,1,26,3,31,34,26,2,76.4705882352941,5.88235294117647,91.1764705882353,8.82352941176471
"217","42","1",0,0,0,0,0,1,1,8,0,0,1,9,0,9,8,53,10,80,90,53,2,58.8888888888889,2.22222222222222,88.8888888888889,11.1111111111111
"218","42","2",1,2,2,4,2,6,3,11,2,4,6,10,4,10,11,74,31,121,152,75,12,49.3421052631579,7.89473684210526,79.6052631578947,20.3947368421053
"219","42","3",1,2,3,5,1,13,11,13,2,6,11,19,7,17,14,48,49,124,173,49,24,28.3236994219653,13.8728323699422,71.6763005780347,28.3236994219653
"220","42","4",3,1,1,3,2,25,6,17,1,4,26,20,3,21,17,30,58,122,180,33,51,18.3333333333333,28.3333333333333,67.7777777777778,32.2222222222222
"221","42","5",2,4,9,6,10,39,10,7,4,11,40,11,5,12,7,6,87,96,183,8,79,4.37158469945355,43.1693989071038,52.4590163934426,47.5409836065574
"222","42","6",9,10,15,12,13,18,10,16,10,16,16,14,13,12,15,22,103,118,221,31,34,14.027149321267,15.3846153846154,53.393665158371,46.606334841629
"223","43","1",1,2,1,3,3,39,2,1,1,2,41,0,0,3,1,0,52,48,100,1,80,1,80,48,52
"224","43","2",0,2,4,0,2,6,4,4,2,2,5,8,2,6,4,2,22,31,53,2,11,3.77358490566038,20.7547169811321,58.4905660377358,41.5094339622642
"225","43","3",0,0,0,0,0,0,0,0,0,0,0,0,0,0,0,0,0,0,0,0,0,NA,NA,NA,NA
"226","43","4",0,0,0,0,0,1,0,1,0,0,0,1,0,0,1,0,2,2,4,0,1,0,25,50,50
"227","43","5",0,0,0,0,0,0,0,0,0,0,0,0,0,0,0,0,0,0,0,0,0,NA,NA,NA,NA
"228","43","6",0,0,0,0,0,0,0,0,1,0,0,0,1,0,0,0,0,2,2,0,0,0,0,100,0
"229","44","1",0,2,5,0,2,7,1,5,1,3,4,6,2,4,5,3,22,28,50,3,11,6,22,56,44
"230","44","2",0,1,0,1,0,2,2,1,1,0,2,2,1,1,0,1,7,8,15,1,4,6.66666666666667,26.6666666666667,53.3333333333333,46.6666666666667
"231","44","3",0,0,0,0,1,5,0,0,0,1,6,0,0,1,1,0,6,9,15,0,11,0,73.3333333333333,60,40
"232","44","4",1,1,1,1,1,2,0,0,1,0,2,0,0,0,0,0,7,3,10,1,4,10,40,30,70
"233","44","5",0,0,0,0,0,0,0,1,0,0,0,0,0,0,0,2,1,2,3,2,0,66.6666666666667,0,66.6666666666667,33.3333333333333
"234","44","6",0,0,0,0,0,0,0,0,0,0,0,0,0,0,0,1,0,1,1,1,0,100,0,100,0
"235","45","1",0,0,0,0,0,1,0,0,0,0,2,0,0,1,1,1,1,5,6,1,3,16.6666666666667,50,83.3333333333333,16.6666666666667
"236","45","2",0,0,0,0,0,1,0,0,0,0,0,0,0,0,0,0,1,0,1,0,1,0,100,0,100
"237","45","3",0,0,0,0,0,0,0,0,0,0,0,0,0,0,0,0,0,0,0,0,0,NA,NA,NA,NA
"238","45","4",0,0,0,0,0,1,0,0,0,0,1,0,0,0,0,0,1,1,2,0,2,0,100,50,50
"239","45","5",0,0,0,0,0,4,0,0,0,0,4,0,0,0,0,0,4,4,8,0,8,0,100,50,50
"240","45","6",0,0,0,0,0,4,1,0,0,0,4,1,1,0,0,0,5,6,11,0,8,0,72.7272727272727,54.5454545454545,45.4545454545455
"241","46","1",0,0,1,0,0,10,0,0,0,1,10,0,0,0,0,0,11,11,22,0,20,0,90.9090909090909,50,50
"242","46","2",0,1,1,0,1,11,0,0,1,0,11,0,0,0,0,0,14,12,26,0,22,0,84.6153846153846,46.1538461538462,53.8461538461538
"243","46","3",0,0,0,0,0,2,1,0,0,0,2,1,0,1,0,0,3,4,7,0,4,0,57.1428571428571,57.1428571428571,42.8571428571429
"244","46","4",0,0,0,0,0,0,0,0,0,0,0,0,0,0,0,0,0,0,0,0,0,NA,NA,NA,NA
"245","46","5",0,0,0,0,0,0,0,0,0,0,0,0,0,0,0,0,0,0,0,0,0,NA,NA,NA,NA
"246","46","6",0,0,0,0,0,0,0,0,0,0,0,0,0,0,0,0,0,0,0,0,0,NA,NA,NA,NA
"247","47","1",2,1,1,1,2,17,1,0,1,1,18,0,0,1,0,0,25,21,46,2,35,4.34782608695652,76.0869565217391,45.6521739130435,54.3478260869565
"248","47","2",0,0,0,0,0,0,0,0,0,0,0,0,0,0,0,0,0,0,0,0,0,NA,NA,NA,NA
"249","47","3",0,0,0,0,1,0,0,0,0,1,0,0,0,0,0,0,1,1,2,0,0,0,0,50,50
"250","47","4",0,0,0,0,0,0,0,0,0,0,0,0,0,0,0,0,0,0,0,0,0,NA,NA,NA,NA
"251","47","5",0,0,0,0,0,0,0,0,0,0,0,0,0,0,0,0,0,0,0,0,0,NA,NA,NA,NA
"252","47","6",0,0,0,0,0,0,0,0,0,0,0,0,0,0,0,0,0,0,0,0,0,NA,NA,NA,NA
"253","48","1",0,0,0,1,0,0,0,1,0,0,0,0,0,1,1,0,2,2,4,0,0,0,0,50,50
"254","48","2",0,0,0,0,0,0,0,0,0,0,0,0,0,0,0,0,0,0,0,0,0,NA,NA,NA,NA
"255","48","3",0,0,0,0,0,0,0,0,0,0,0,0,0,0,0,0,0,0,0,0,0,NA,NA,NA,NA
"256","48","4",0,0,0,0,0,0,0,0,0,0,0,0,0,0,0,0,0,0,0,0,0,NA,NA,NA,NA
"257","48","5",0,0,0,0,0,0,0,0,0,0,0,0,0,0,0,0,0,0,0,0,0,NA,NA,NA,NA
"258","48","6",0,0,0,0,0,0,0,0,0,0,0,0,0,0,0,0,0,0,0,0,0,NA,NA,NA,NA
"259","49","1",0,0,0,0,0,0,0,0,0,0,0,0,0,0,0,0,0,0,0,0,0,NA,NA,NA,NA
"260","49","2",0,0,0,0,0,0,0,0,0,0,0,0,0,0,0,0,0,0,0,0,0,NA,NA,NA,NA
"261","49","3",0,0,0,0,0,0,0,0,0,0,0,0,0,0,0,0,0,0,0,0,0,NA,NA,NA,NA
"262","49","4",0,0,0,0,0,0,0,0,0,0,0,0,0,0,0,0,0,0,0,0,0,NA,NA,NA,NA
"263","49","5",0,0,0,0,0,0,0,0,0,0,0,0,0,0,0,0,0,0,0,0,0,NA,NA,NA,NA
"264","49","6",0,0,0,0,0,0,0,0,0,0,0,0,0,0,0,1,0,1,1,1,0,100,0,100,0
"265","5","1",0,0,0,0,0,1,1,0,0,0,0,1,0,0,0,0,2,1,3,0,1,0,33.3333333333333,33.3333333333333,66.6666666666667
"266","5","2",0,0,1,0,0,1,0,0,0,1,0,0,1,0,0,0,2,2,4,0,1,0,25,50,50
"267","5","3",0,0,0,0,0,0,0,0,0,0,0,0,0,0,0,0,0,0,0,0,0,NA,NA,NA,NA
"268","5","4",0,0,0,0,0,0,0,0,0,0,0,0,0,0,0,0,0,0,0,0,0,NA,NA,NA,NA
"269","5","5",0,0,0,0,0,1,0,0,0,0,1,0,0,0,0,0,1,1,2,0,2,0,100,50,50
"270","5","6",0,0,0,0,0,0,0,0,0,0,0,0,0,0,0,0,0,0,0,0,0,NA,NA,NA,NA
"271","50","1",5,0,0,0,0,0,0,0,1,0,0,0,1,0,1,1,5,4,9,6,0,66.6666666666667,0,44.4444444444444,55.5555555555556
"272","50","2",0,1,1,0,1,0,0,0,1,0,0,0,0,0,0,0,3,1,4,0,0,0,0,25,75
"273","50","3",1,0,0,0,0,0,0,0,0,0,0,0,0,0,0,0,1,0,1,1,0,100,0,0,100
"274","50","4",0,1,0,0,0,0,0,0,0,0,0,0,0,0,0,0,1,0,1,0,0,0,0,0,100
"275","50","5",0,0,0,0,0,0,0,0,0,0,0,0,0,0,0,0,0,0,0,0,0,NA,NA,NA,NA
"276","50","6",0,0,0,0,0,0,0,0,0,0,0,0,0,0,0,0,0,0,0,0,0,NA,NA,NA,NA
"277","51","1",0,0,0,1,0,0,0,1,0,0,0,0,0,0,1,1,2,2,4,1,0,25,0,50,50
"278","51","2",0,1,1,0,2,0,0,0,1,0,1,0,0,1,0,0,4,3,7,0,1,0,14.2857142857143,42.8571428571429,57.1428571428571
"279","51","3",0,0,0,0,0,0,0,0,0,0,0,0,0,0,0,0,0,0,0,0,0,NA,NA,NA,NA
"280","51","4",0,0,0,0,0,0,0,0,0,0,0,0,0,0,0,0,0,0,0,0,0,NA,NA,NA,NA
"281","51","5",0,0,0,0,0,0,0,0,0,0,0,0,0,0,0,0,0,0,0,0,0,NA,NA,NA,NA
"282","51","6",0,0,0,0,0,0,0,0,0,0,0,0,0,0,0,0,0,0,0,0,0,NA,NA,NA,NA
"283","52","1",0,1,0,1,0,0,0,3,1,0,0,2,1,1,2,8,5,15,20,8,0,40,0,75,25
"284","52","2",0,0,0,0,0,0,0,1,0,0,0,1,0,1,2,0,1,4,5,0,0,0,0,80,20
"285","52","3",0,0,0,0,0,1,1,0,0,0,1,1,0,1,0,0,2,3,5,0,2,0,40,60,40
"286","52","4",0,0,0,0,0,0,0,1,0,0,0,1,0,1,0,14,1,16,17,14,0,82.3529411764706,0,94.1176470588235,5.88235294117647
"287","52","5",0,0,0,4,0,0,3,1,0,4,0,0,4,0,1,12,8,21,29,12,0,41.3793103448276,0,72.4137931034483,27.5862068965517
"288","52","6",0,0,0,2,0,0,1,3,0,2,0,2,2,2,4,10,6,22,28,10,0,35.7142857142857,0,78.5714285714286,21.4285714285714
"289","53","1",1,1,3,4,1,11,5,12,1,6,9,13,6,11,12,49,38,107,145,50,20,34.4827586206897,13.7931034482759,73.7931034482759,26.2068965517241
"290","53","2",0,0,0,2,0,11,2,22,0,2,11,22,2,22,21,98,37,178,215,98,22,45.5813953488372,10.2325581395349,82.7906976744186,17.2093023255814
"291","53","3",0,0,0,2,1,9,4,32,0,2,10,34,1,35,32,68,48,182,230,68,19,29.5652173913043,8.26086956521739,79.1304347826087,20.8695652173913
"292","53","4",0,0,0,0,0,7,0,32,0,0,7,32,0,32,33,89,39,193,232,89,14,38.3620689655172,6.03448275862069,83.1896551724138,16.8103448275862
"293","53","5",0,0,0,0,0,3,0,38,0,0,3,38,0,39,38,59,41,177,218,59,6,27.0642201834862,2.75229357798165,81.1926605504587,18.8073394495413
"294","53","6",0,0,0,1,0,11,2,41,0,1,11,42,1,41,40,66,55,202,257,66,22,25.6809338521401,8.56031128404669,78.5992217898833,21.4007782101167
"295","54","1",0,0,2,0,1,4,0,0,0,2,3,0,1,0,1,3,7,10,17,3,7,17.6470588235294,41.1764705882353,58.8235294117647,41.1764705882353
"296","54","2",0,0,2,0,1,2,1,1,0,2,1,2,1,0,1,0,7,7,14,0,3,0,21.4285714285714,50,50
"297","54","3",0,0,0,0,0,0,0,0,0,0,0,0,0,0,0,0,0,0,0,0,0,NA,NA,NA,NA
"298","54","4",0,0,0,0,0,0,0,0,0,0,0,0,0,0,0,0,0,0,0,0,0,NA,NA,NA,NA
"299","54","5",0,0,0,0,0,0,0,0,0,0,0,0,0,0,0,0,0,0,0,0,0,NA,NA,NA,NA
"300","54","6",0,0,0,0,0,0,0,0,0,0,0,0,0,0,0,0,0,0,0,0,0,NA,NA,NA,NA
"301","56","1",0,0,0,0,0,0,0,0,0,0,0,0,0,0,0,0,0,0,0,0,0,NA,NA,NA,NA
"302","56","2",1,2,0,1,0,0,0,3,2,0,0,2,1,2,3,1,7,11,18,2,0,11.1111111111111,0,61.1111111111111,38.8888888888889
"303","56","3",0,0,0,1,0,0,0,0,0,0,0,0,0,0,0,0,1,0,1,0,0,0,0,0,100
"304","56","4",0,0,0,0,0,0,0,1,0,0,0,0,0,0,0,1,1,1,2,1,0,50,0,50,50
"305","56","5",0,0,0,0,0,0,0,0,0,0,0,0,0,0,0,0,0,0,0,0,0,NA,NA,NA,NA
"306","56","6",0,0,0,0,0,0,0,0,0,0,0,0,1,0,1,6,0,8,8,6,0,75,0,100,0
"307","57","1",5,2,1,1,0,1,2,1,2,0,0,3,1,2,1,0,13,9,22,5,1,22.7272727272727,4.54545454545455,40.9090909090909,59.0909090909091
"308","57","2",0,0,0,0,0,0,0,0,0,0,0,0,0,0,0,0,0,0,0,0,0,NA,NA,NA,NA
"309","57","3",0,0,0,0,0,0,0,0,0,0,0,0,0,0,0,0,0,0,0,0,0,NA,NA,NA,NA
"310","57","4",0,0,0,0,0,0,0,0,0,0,0,0,0,0,0,0,0,0,0,0,0,NA,NA,NA,NA
"311","57","5",0,0,0,0,0,0,0,0,0,0,0,0,0,0,0,0,0,0,0,0,0,NA,NA,NA,NA
"312","57","6",0,0,0,0,0,0,0,0,0,0,0,0,0,0,0,0,0,0,0,0,0,NA,NA,NA,NA
"313","58","1",19,5,5,5,8,1,3,5,5,5,4,2,3,5,5,7,51,36,87,26,5,29.8850574712644,5.74712643678161,41.3793103448276,58.6206896551724
"314","58","2",62,7,9,0,8,3,1,0,8,2,2,1,1,0,0,0,90,14,104,62,5,59.6153846153846,4.80769230769231,13.4615384615385,86.5384615384615
"315","58","3",54,10,9,2,9,0,2,0,10,1,0,0,2,0,0,0,86,13,99,54,0,54.5454545454545,0,13.1313131313131,86.8686868686869
"316","58","4",44,6,6,1,6,0,0,1,6,1,0,0,1,0,1,0,64,9,73,44,0,60.2739726027397,0,12.3287671232877,87.6712328767123
"317","58","5",6,1,1,0,1,0,0,0,1,0,0,0,0,0,0,0,9,1,10,6,0,60,0,10,90
"318","58","6",6,1,0,1,0,0,0,1,0,0,0,0,0,0,0,0,9,0,9,6,0,66.6666666666667,0,0,100
"319","59","1",0,0,0,1,0,0,1,0,0,1,0,0,1,0,0,0,2,2,4,0,0,0,0,50,50
"320","59","2",0,0,0,0,0,0,0,0,0,0,0,0,0,0,0,0,0,0,0,0,0,NA,NA,NA,NA
"321","59","3",0,0,0,0,0,0,0,0,0,0,0,0,0,0,0,0,0,0,0,0,0,NA,NA,NA,NA
"322","59","4",0,0,0,0,0,0,0,0,0,0,0,0,0,0,0,0,0,0,0,0,0,NA,NA,NA,NA
"323","59","5",0,0,0,0,0,0,0,0,0,0,0,0,0,0,0,0,0,0,0,0,0,NA,NA,NA,NA
"324","59","6",0,0,0,0,0,0,0,0,0,0,0,0,0,0,0,0,0,0,0,0,0,NA,NA,NA,NA
"325","6","1",0,0,0,0,0,1,0,1,0,0,1,1,0,0,0,1,2,3,5,1,2,20,40,60,40
"326","6","2",0,0,0,0,0,0,0,0,0,0,0,0,0,0,0,0,0,0,0,0,0,NA,NA,NA,NA
"327","6","3",0,0,0,0,0,0,0,0,0,0,0,0,0,0,0,0,0,0,0,0,0,NA,NA,NA,NA
"328","6","4",0,0,0,0,0,0,0,1,0,0,0,1,0,1,2,2,1,6,7,2,0,28.5714285714286,0,85.7142857142857,14.2857142857143
"329","6","5",77,5,5,0,6,1,0,0,6,0,2,0,0,1,0,0,94,9,103,77,3,74.7572815533981,2.9126213592233,8.7378640776699,91.2621359223301
"330","6","6",105,3,3,0,2,0,0,0,2,0,0,0,0,0,0,0,113,2,115,105,0,91.304347826087,0,1.73913043478261,98.2608695652174
"331","60","1",0,0,0,0,0,0,0,0,0,0,0,0,0,0,0,0,0,0,0,0,0,NA,NA,NA,NA
"332","60","2",0,0,0,0,0,0,0,0,0,0,0,0,0,0,0,0,0,0,0,0,0,NA,NA,NA,NA
"333","60","3",0,0,0,0,0,0,0,0,0,0,0,0,1,0,0,0,0,1,1,0,0,0,0,100,0
"334","60","4",0,0,0,0,0,0,0,0,0,0,0,0,0,0,0,0,0,0,0,0,0,NA,NA,NA,NA
"335","60","5",0,0,0,0,0,0,0,0,0,0,0,0,0,0,0,0,0,0,0,0,0,NA,NA,NA,NA
"336","60","6",0,0,0,0,0,0,0,0,0,0,0,0,0,0,0,0,0,0,0,0,0,NA,NA,NA,NA
"337","61","1",2,2,2,1,0,6,3,9,2,1,4,11,3,9,9,25,25,64,89,27,10,30.3370786516854,11.2359550561798,71.9101123595506,28.0898876404494
"338","61","2",1,1,4,1,2,5,1,3,1,4,4,3,3,2,4,24,18,45,63,25,9,39.6825396825397,14.2857142857143,71.4285714285714,28.5714285714286
"339","61","3",2,3,4,0,2,14,1,3,3,2,11,4,3,1,3,3,29,30,59,5,25,8.47457627118644,42.3728813559322,50.8474576271186,49.1525423728814
"340","61","4",1,1,3,0,2,1,1,0,1,1,0,1,0,1,0,0,9,4,13,1,1,7.69230769230769,7.69230769230769,30.7692307692308,69.2307692307692
"341","61","5",0,0,0,0,0,0,0,0,0,0,1,0,0,0,0,0,0,1,1,0,1,0,100,100,0
"342","61","6",1,1,2,0,1,2,1,0,1,1,1,1,1,0,0,0,8,5,13,1,3,7.69230769230769,23.0769230769231,38.4615384615385,61.5384615384615
"343","62","1",16,3,5,1,6,7,1,0,3,4,7,0,1,0,0,0,39,15,54,16,14,29.6296296296296,25.9259259259259,27.7777777777778,72.2222222222222
"344","62","2",0,0,2,1,2,11,2,5,0,2,11,7,0,7,5,29,23,61,84,29,22,34.5238095238095,26.1904761904762,72.6190476190476,27.3809523809524
"345","62","3",0,1,1,1,2,5,3,2,1,1,6,3,0,5,2,0,15,18,33,0,11,0,33.3333333333333,54.5454545454545,45.4545454545455
"346","62","4",0,1,1,0,2,1,1,0,1,1,2,1,0,1,0,0,6,6,12,0,3,0,25,50,50
"347","62","5",0,0,0,1,0,0,0,2,0,0,0,1,0,1,1,18,3,21,24,18,0,75,0,87.5,12.5
"348","62","6",0,0,0,0,0,0,0,0,0,0,0,0,0,0,0,56,0,56,56,56,0,100,0,100,0
"349","63","1",0,0,0,1,0,0,0,2,0,1,0,1,1,1,2,3,3,9,12,3,0,25,0,75,25
"350","63","2",0,0,0,0,0,0,0,0,0,0,0,0,0,0,0,14,0,14,14,14,0,100,0,100,0
"351","63","3",2,1,1,0,0,4,2,1,1,1,3,3,2,2,2,2,11,16,27,4,7,14.8148148148148,25.9259259259259,59.2592592592593,40.7407407407407
"352","63","4",0,0,0,1,0,0,0,1,0,0,0,1,0,1,1,1,2,4,6,1,0,16.6666666666667,0,66.6666666666667,33.3333333333333
"353","63","5",0,0,0,0,0,0,0,1,0,0,0,0,1,0,1,1,1,3,4,1,0,25,0,75,25
"354","63","6",0,0,2,0,0,1,1,2,0,2,0,3,1,2,2,4,6,14,20,4,1,20,5,70,30
"355","64","1",0,0,0,0,0,0,0,0,0,0,0,0,0,0,0,0,0,0,0,0,0,NA,NA,NA,NA
"356","64","2",0,0,0,0,0,0,0,0,0,0,0,0,0,0,0,0,0,0,0,0,0,NA,NA,NA,NA
"357","64","3",0,0,2,0,3,0,0,0,0,2,0,0,0,0,0,0,5,2,7,0,0,0,0,28.5714285714286,71.4285714285714
"358","64","4",2,1,2,1,3,1,1,0,1,3,2,0,0,1,0,0,11,7,18,2,3,11.1111111111111,16.6666666666667,38.8888888888889,61.1111111111111
"359","64","5",0,0,2,0,1,2,1,1,0,1,1,2,0,1,0,7,7,12,19,7,3,36.8421052631579,15.7894736842105,63.1578947368421,36.8421052631579
"360","64","6",0,0,0,0,0,0,0,0,0,0,0,0,0,0,0,0,0,0,0,0,0,NA,NA,NA,NA
"361","65","1",0,0,0,0,0,0,0,0,0,0,0,0,1,0,1,0,0,2,2,0,0,0,0,100,0
"362","65","2",0,0,0,0,0,0,0,0,0,0,0,0,0,0,0,0,0,0,0,0,0,NA,NA,NA,NA
"363","65","3",0,0,0,0,0,0,0,0,0,0,0,0,0,0,0,0,0,0,0,0,0,NA,NA,NA,NA
"364","65","4",0,0,0,0,0,0,0,0,0,0,0,0,0,0,0,0,0,0,0,0,0,NA,NA,NA,NA
"365","65","5",0,0,0,0,0,0,0,0,0,0,0,0,0,0,0,0,0,0,0,0,0,NA,NA,NA,NA
"366","65","6",0,0,0,0,0,0,0,0,0,0,0,0,0,0,0,0,0,0,0,0,0,NA,NA,NA,NA
"367","66","1",2,1,0,1,0,0,1,0,1,0,0,0,1,0,1,0,5,3,8,2,0,25,0,37.5,62.5
"368","66","2",1,1,1,0,0,1,0,0,1,0,0,0,1,0,0,0,4,2,6,1,1,16.6666666666667,16.6666666666667,33.3333333333333,66.6666666666667
"369","66","3",4,1,0,0,1,2,2,0,1,0,3,2,0,2,0,0,10,8,18,4,5,22.2222222222222,27.7777777777778,44.4444444444444,55.5555555555556
"370","66","4",0,1,1,1,0,0,1,0,1,0,0,0,1,0,0,0,4,2,6,0,0,0,0,33.3333333333333,66.6666666666667
"371","66","5",0,0,0,0,0,0,0,0,0,0,0,0,0,0,0,0,0,0,0,0,0,NA,NA,NA,NA
"372","66","6",0,0,0,0,0,0,0,0,0,0,0,0,0,0,0,0,0,0,0,0,0,NA,NA,NA,NA
"373","67","1",0,0,0,1,0,0,0,3,0,1,0,2,0,2,2,2,4,9,13,2,0,15.3846153846154,0,69.2307692307692,30.7692307692308
"374","67","2",0,0,0,0,0,0,0,0,0,0,0,0,0,0,0,0,0,0,0,0,0,NA,NA,NA,NA
"375","67","3",0,0,0,0,0,0,0,0,0,0,0,0,0,0,0,1,0,1,1,1,0,100,0,100,0
"376","67","4",0,0,0,0,0,0,0,0,0,0,0,0,0,0,0,1,0,1,1,1,0,100,0,100,0
"377","67","5",0,0,0,0,0,0,0,0,0,0,0,0,0,0,0,3,0,3,3,3,0,100,0,100,0
"378","67","6",0,0,0,0,0,0,0,0,0,0,0,0,0,0,0,1,0,1,1,1,0,100,0,100,0
"379","68","1",0,0,0,0,0,0,0,0,0,0,0,0,0,0,0,0,0,0,0,0,0,NA,NA,NA,NA
"380","68","2",0,0,0,0,0,0,0,0,0,0,0,0,0,0,0,0,0,0,0,0,0,NA,NA,NA,NA
"381","68","3",0,0,0,0,0,0,0,0,1,0,0,0,0,0,0,0,0,1,1,0,0,0,0,100,0
"382","68","4",1,1,1,0,0,0,0,0,0,0,0,0,0,0,0,0,3,0,3,1,0,33.3333333333333,0,0,100
"383","68","5",0,0,0,0,0,3,0,1,0,0,2,1,0,0,1,0,4,4,8,0,5,0,62.5,50,50
"384","68","6",0,0,0,0,0,2,0,0,0,0,2,1,0,1,0,0,2,4,6,0,4,0,66.6666666666667,66.6666666666667,33.3333333333333
"385","69","1",0,0,0,0,0,0,0,0,0,0,0,0,0,0,0,0,0,0,0,0,0,NA,NA,NA,NA
"386","69","2",0,1,0,1,1,0,0,1,1,0,1,0,0,1,1,0,4,4,8,0,1,0,12.5,50,50
"387","69","3",0,0,0,0,0,0,0,0,0,0,0,0,0,0,0,0,0,0,0,0,0,NA,NA,NA,NA
"388","69","4",0,0,0,0,0,0,0,0,0,0,0,0,0,0,0,0,0,0,0,0,0,NA,NA,NA,NA
"389","69","5",0,0,0,0,0,0,0,1,0,0,0,0,0,0,1,0,1,1,2,0,0,0,0,50,50
"390","69","6",0,0,0,0,0,0,0,0,0,0,0,0,0,0,0,0,0,0,0,0,0,NA,NA,NA,NA
"391","7","1",20,12,11,12,19,11,12,1,12,11,18,1,5,8,1,1,98,57,155,21,29,13.5483870967742,18.7096774193548,36.7741935483871,63.2258064516129
"392","7","2",21,8,9,3,11,7,3,1,9,4,9,1,1,3,1,0,63,28,91,21,16,23.0769230769231,17.5824175824176,30.7692307692308,69.2307692307692
"393","7","3",20,12,12,3,13,7,3,0,11,3,9,0,1,2,0,0,70,26,96,20,16,20.8333333333333,16.6666666666667,27.0833333333333,72.9166666666667
"394","7","4",16,9,8,3,11,11,3,0,9,2,14,0,0,3,0,0,61,28,89,16,25,17.9775280898876,28.0898876404494,31.4606741573034,68.5393258426966
"395","7","5",15,11,11,3,14,8,3,0,12,3,10,0,1,2,0,0,65,28,93,15,18,16.1290322580645,19.3548387096774,30.1075268817204,69.8924731182796
"396","7","6",11,8,8,1,8,8,1,0,7,1,9,0,0,1,0,0,45,18,63,11,17,17.4603174603175,26.984126984127,28.5714285714286,71.4285714285714
"397","70","1",0,0,0,0,0,0,0,0,0,0,0,0,0,0,0,0,0,0,0,0,0,NA,NA,NA,NA
"398","70","2",0,1,6,1,4,75,5,2,1,6,72,6,3,3,2,1,94,94,188,1,147,0.531914893617021,78.1914893617021,50,50
"399","70","3",0,0,0,0,1,65,1,0,0,1,66,1,0,2,0,0,67,70,137,0,131,0,95.6204379562044,51.0948905109489,48.9051094890511
"400","70","4",0,0,1,0,0,0,0,0,0,0,0,0,0,0,0,0,1,0,1,0,0,0,0,0,100
"401","70","5",1,1,1,0,1,31,0,0,1,0,30,0,0,0,0,0,35,31,66,1,61,1.51515151515152,92.4242424242424,46.969696969697,53.030303030303
"402","70","6",0,0,0,0,0,61,0,0,0,0,61,1,0,0,0,0,61,62,123,0,122,0,99.1869918699187,50.4065040650407,49.5934959349593
"403","71","1",1,2,2,0,1,11,1,2,2,0,11,2,1,2,2,6,20,26,46,7,22,15.2173913043478,47.8260869565217,56.5217391304348,43.4782608695652
"404","71","2",0,2,3,1,3,38,2,3,2,2,37,4,1,4,3,1,52,54,106,1,75,0.943396226415094,70.7547169811321,50.9433962264151,49.0566037735849
"405","71","3",0,0,0,0,0,11,1,1,0,1,11,2,1,1,1,1,13,18,31,1,22,3.2258064516129,70.9677419354839,58.0645161290323,41.9354838709677
"406","71","4",0,0,2,1,1,3,1,0,0,2,2,0,1,0,0,0,8,5,13,0,5,0,38.4615384615385,38.4615384615385,61.5384615384615
"407","71","5",0,0,0,0,0,0,0,0,0,0,0,0,0,0,0,0,0,0,0,0,0,NA,NA,NA,NA
"408","71","6",0,0,0,0,0,0,1,0,0,0,0,1,0,1,0,0,1,2,3,0,0,0,0,66.6666666666667,33.3333333333333
"409","72","1",0,0,0,0,0,0,0,0,0,0,0,0,0,0,0,0,0,0,0,0,0,NA,NA,NA,NA
"410","72","2",0,0,0,0,0,188,0,0,0,0,188,0,0,0,0,0,188,188,376,0,376,0,100,50,50
"411","72","3",0,0,1,0,0,28,1,0,0,1,28,1,1,0,0,0,30,31,61,0,56,0,91.8032786885246,50.8196721311475,49.1803278688525
"412","72","4",0,0,0,0,0,33,0,0,0,0,33,0,0,0,0,0,33,33,66,0,66,0,100,50,50
"413","72","5",0,0,0,0,0,0,0,0,0,0,0,0,0,0,0,0,0,0,0,0,0,NA,NA,NA,NA
"414","72","6",0,0,0,0,0,0,0,0,0,0,0,0,0,0,0,0,0,0,0,0,0,NA,NA,NA,NA
"415","73","1",10,8,11,5,13,20,2,7,9,8,21,4,4,5,7,3,76,61,137,13,41,9.48905109489051,29.9270072992701,44.5255474452555,55.4744525547445
"416","73","2",1,1,1,0,0,7,3,20,0,0,6,23,0,22,19,31,33,101,134,32,13,23.8805970149254,9.70149253731343,75.3731343283582,24.6268656716418
"417","73","3",0,0,0,1,0,17,3,18,0,1,17,20,1,21,19,38,39,117,156,38,34,24.3589743589744,21.7948717948718,75,25
"418","73","4",0,2,2,3,4,33,7,18,2,3,35,23,1,24,18,19,69,125,194,19,68,9.79381443298969,35.0515463917526,64.4329896907217,35.5670103092784
"419","73","5",0,1,1,1,1,29,3,3,1,1,29,4,1,5,3,2,39,46,85,2,58,2.35294117647059,68.2352941176471,54.1176470588235,45.8823529411765
"420","73","6",0,3,4,3,1,15,8,11,3,4,13,16,6,13,11,12,45,78,123,12,28,9.75609756097561,22.7642276422764,63.4146341463415,36.5853658536585
"421","74","1",1,1,3,0,3,79,9,10,1,2,78,19,0,19,10,3,106,132,238,4,157,1.68067226890756,65.9663865546218,55.4621848739496,44.5378151260504
"422","74","2",0,0,2,0,0,41,13,17,0,3,39,30,3,27,17,9,73,128,201,9,80,4.47761194029851,39.8009950248756,63.681592039801,36.318407960199
"423","74","3",0,0,3,1,2,46,9,3,0,3,45,11,1,11,3,1,64,75,139,1,91,0.719424460431655,65.4676258992806,53.9568345323741,46.0431654676259
"424","74","4",0,0,3,0,2,76,9,7,0,3,75,16,1,14,7,0,97,116,213,0,151,0,70.8920187793427,54.4600938967136,45.5399061032864
"425","74","5",0,0,1,0,1,59,10,11,0,1,59,22,0,22,11,6,82,121,203,6,118,2.95566502463054,58.128078817734,59.6059113300493,40.3940886699507
"426","74","6",0,1,1,0,2,112,3,7,1,1,113,9,0,10,7,5,126,146,272,5,225,1.83823529411765,82.7205882352941,53.6764705882353,46.3235294117647
"427","75","1",0,1,1,2,1,5,2,3,1,1,5,4,1,4,3,4,15,23,38,4,10,10.5263157894737,26.3157894736842,60.5263157894737,39.4736842105263
"428","75","2",0,0,0,0,0,0,0,1,0,0,0,0,0,0,1,0,1,1,2,0,0,0,0,50,50
"429","75","3",0,0,0,1,0,0,0,0,0,1,0,0,1,0,0,0,1,2,3,0,0,0,0,66.6666666666667,33.3333333333333
"430","75","4",0,0,0,0,0,0,1,0,0,0,0,0,1,0,0,0,1,1,2,0,0,0,0,50,50
"431","75","5",0,0,0,1,0,0,0,0,0,1,0,0,0,0,0,0,1,1,2,0,0,0,0,50,50
"432","75","6",0,0,0,0,0,0,2,0,0,0,0,1,0,1,0,0,2,2,4,0,0,0,0,50,50
"433","76","1",2,2,5,1,5,4,1,0,2,4,5,0,1,1,0,0,20,13,33,2,9,6.06060606060606,27.2727272727273,39.3939393939394,60.6060606060606
"434","76","2",0,0,0,1,1,1,2,0,0,1,1,1,0,2,0,0,5,5,10,0,2,0,20,50,50
"435","76","3",2,1,1,0,0,2,1,1,1,0,1,2,1,0,1,0,8,6,14,2,3,14.2857142857143,21.4285714285714,42.8571428571429,57.1428571428571
"436","76","4",0,1,0,1,0,1,0,2,1,0,1,1,1,1,1,1,5,7,12,1,2,8.33333333333333,16.6666666666667,58.3333333333333,41.6666666666667
"437","76","5",0,0,0,0,0,2,0,0,0,0,2,0,0,1,1,1,2,5,7,1,4,14.2857142857143,57.1428571428571,71.4285714285714,28.5714285714286
"438","76","6",0,0,0,0,0,3,2,0,0,0,3,2,0,1,0,0,6,8,14,0,6,0,42.8571428571429,57.1428571428571,42.8571428571429
"439","8","1",3,2,5,2,7,3,2,0,3,5,4,0,1,1,0,0,24,14,38,3,7,7.89473684210526,18.4210526315789,36.8421052631579,63.1578947368421
"440","8","2",16,3,2,2,2,0,2,0,3,1,0,0,2,0,0,0,27,6,33,16,0,48.4848484848485,0,18.1818181818182,81.8181818181818
"441","8","3",23,3,3,1,3,0,1,0,3,1,0,0,1,0,0,0,34,5,39,23,0,58.974358974359,0,12.8205128205128,87.1794871794872
"442","8","4",42,2,2,0,2,0,0,0,2,0,0,0,0,0,0,0,48,2,50,42,0,84,0,4,96
"443","8","5",34,3,3,0,3,0,0,0,2,0,0,0,0,0,0,0,43,2,45,34,0,75.5555555555556,0,4.44444444444444,95.5555555555556
"444","8","6",17,2,2,0,2,1,0,0,3,0,1,0,0,0,0,0,24,4,28,17,2,60.7142857142857,7.14285714285714,14.2857142857143,85.7142857142857
"445","9","1",2,1,0,2,1,14,2,0,0,1,16,0,0,2,0,0,22,19,41,2,30,4.8780487804878,73.1707317073171,46.3414634146341,53.6585365853659
"446","9","2",0,0,0,1,1,10,0,2,1,1,10,1,1,1,2,6,14,23,37,6,20,16.2162162162162,54.0540540540541,62.1621621621622,37.8378378378378
"447","9","3",1,2,1,2,1,1,0,3,1,2,1,1,2,1,3,6,11,17,28,7,2,25,7.14285714285714,60.7142857142857,39.2857142857143
"448","9","4",3,0,0,2,0,0,1,3,1,1,0,2,2,2,3,10,9,21,30,13,0,43.3333333333333,0,70,30
"449","9","5",6,2,2,5,2,2,4,2,2,5,2,1,5,1,2,3,25,21,46,9,4,19.5652173913043,8.69565217391304,45.6521739130435,54.3478260869565
"450","9","6",1,1,1,0,0,3,1,2,0,0,2,3,0,3,2,4,9,14,23,5,5,21.7391304347826,21.7391304347826,60.8695652173913,39.1304347826087
