"","fish_id","bin","LLLL","LLLR","LLRL","LLRR","LRLL","LRLR","LRRL","LRRR","RLLL","RLLR","RLRL","RLRR","RRLL","RRLR","RRRL","RRRR","L","R","total_turns","reps","alts","rel_reps","rel_alts","rel_R","rel_L"
"1","1","1",1,4,5,2,5,7,2,8,4,3,7,7,2,7,7,34,34,74,108,35,14,32.4074074074074,12.962962962963,68.5185185185185,31.4814814814815
"2","1","2",0,2,5,3,3,11,3,8,2,6,9,8,5,6,8,26,35,73,108,26,20,24.0740740740741,18.5185185185185,67.5925925925926,32.4074074074074
"3","1","3",11,8,8,5,7,9,5,3,7,5,8,3,5,3,3,2,57,38,95,13,17,13.6842105263158,17.8947368421053,40,60
"4","1","4",4,5,6,5,8,1,2,6,4,6,3,3,3,5,6,9,39,40,79,13,4,16.4556962025316,5.06329113924051,50.6329113924051,49.3670886075949
"5","1","5",0,2,3,3,4,3,5,0,2,3,4,2,2,3,0,0,22,17,39,0,7,0,17.9487179487179,43.5897435897436,56.4102564102564
"6","1","6",5,4,5,0,4,1,0,2,3,1,0,2,1,1,2,0,23,11,34,5,1,14.7058823529412,2.94117647058824,32.3529411764706,67.6470588235294
"7","10","1",1,2,5,1,4,7,1,6,3,4,6,6,3,4,6,3,30,35,65,4,13,6.15384615384615,20,53.8461538461538,46.1538461538462
"8","10","2",5,3,2,1,2,0,0,5,3,0,0,4,1,4,5,37,18,57,75,42,0,56,0,76,24
"9","10","3",0,0,0,0,0,1,0,2,0,0,1,2,0,2,2,29,3,39,42,29,2,69.0476190476191,4.76190476190476,92.8571428571429,7.14285714285714
"10","10","4",0,0,1,0,1,1,1,1,0,1,1,2,0,2,1,19,7,27,34,19,2,55.8823529411765,5.88235294117647,79.4117647058823,20.5882352941176
"11","10","5",0,0,0,0,0,0,1,1,0,0,0,1,0,1,0,1,2,6,8,1,0,12.5,0,75,25
"12","10","6",0,0,0,0,0,0,0,0,0,0,0,0,0,0,0,1,0,4,4,1,0,25,0,100,0
"13","11","1",2,1,1,4,2,5,1,8,1,4,6,4,3,5,7,45,24,78,102,47,11,46.078431372549,10.7843137254902,76.4705882352941,23.5294117647059
"14","11","2",1,1,7,12,7,9,12,8,1,18,9,8,11,8,7,17,57,82,139,18,18,12.9496402877698,12.9496402877698,58.9928057553957,41.0071942446043
"15","11","3",0,1,0,8,3,3,2,9,1,7,6,3,5,6,10,35,27,75,102,35,9,34.3137254901961,8.82352941176471,73.5294117647059,26.4705882352941
"16","11","4",0,0,1,5,2,4,3,2,0,5,5,0,3,2,2,4,18,23,41,4,9,9.75609756097561,21.9512195121951,56.0975609756098,43.9024390243902
"17","11","5",0,0,1,0,0,1,1,0,0,1,0,0,1,0,0,0,4,4,8,0,1,0,12.5,50,50
"18","11","6",0,0,1,0,1,3,0,1,0,1,3,1,1,1,2,1,8,11,19,1,6,5.26315789473684,31.5789473684211,57.8947368421053,42.1052631578947
"19","112","1",0,0,0,0,0,0,0,0,0,0,0,0,0,0,0,0,0,0,0,0,0,NA,NA,NA,NA
"20","112","2",0,0,0,0,0,0,0,0,0,0,0,0,0,0,0,0,0,0,0,0,0,NA,NA,NA,NA
"21","112","3",0,0,0,0,0,0,0,0,0,0,0,0,0,0,0,0,0,0,0,0,0,NA,NA,NA,NA
"22","112","4",0,0,0,0,0,0,0,0,0,0,0,0,0,0,0,0,0,0,0,0,0,NA,NA,NA,NA
"23","112","5",0,0,0,0,0,0,0,0,0,0,0,0,0,0,0,0,0,0,0,0,0,NA,NA,NA,NA
"24","112","6",0,0,0,0,0,9,0,0,0,0,10,0,0,0,0,0,11,11,22,0,19,0,86.3636363636364,50,50
"25","12","1",28,10,11,7,12,8,6,3,10,7,9,2,5,3,3,2,86,43,129,30,17,23.2558139534884,13.1782945736434,33.3333333333333,66.6666666666667
"26","12","2",17,9,12,5,13,7,9,1,9,8,8,5,4,6,1,1,75,43,118,18,15,15.2542372881356,12.7118644067797,36.4406779661017,63.5593220338983
"27","12","3",45,8,9,1,11,1,1,0,9,2,2,0,0,1,0,0,79,14,93,45,3,48.3870967741936,3.2258064516129,15.0537634408602,84.9462365591398
"28","12","4",74,5,3,2,3,0,2,0,5,0,0,0,2,0,0,0,92,7,99,74,0,74.7474747474748,0,7.07070707070707,92.9292929292929
"29","12","5",38,4,3,1,3,2,1,0,4,0,2,0,1,0,0,0,55,7,62,38,4,61.2903225806452,6.45161290322581,11.2903225806452,88.7096774193548
"30","12","6",34,3,4,0,4,0,0,0,3,1,0,0,0,0,0,0,48,4,52,34,0,65.3846153846154,0,7.69230769230769,92.3076923076923
"31","13","1",6,3,3,4,5,4,5,2,4,4,6,2,3,4,2,2,35,27,62,8,10,12.9032258064516,16.1290322580645,43.5483870967742,56.4516129032258
"32","13","2",31,5,4,2,3,2,2,1,4,1,1,1,3,0,1,0,52,12,64,31,3,48.4375,4.6875,18.75,81.25
"33","13","3",17,1,1,0,0,0,0,0,0,0,0,0,0,0,0,0,21,1,22,17,0,77.2727272727273,0,4.54545454545455,95.4545454545455
"34","13","4",11,1,1,0,1,0,0,0,1,0,0,0,0,0,0,0,17,1,18,11,0,61.1111111111111,0,5.55555555555556,94.4444444444444
"35","13","5",9,2,1,1,2,0,1,0,2,0,1,0,0,1,0,0,19,4,23,9,1,39.1304347826087,4.34782608695652,17.3913043478261,82.6086956521739
"36","13","6",27,0,0,0,0,0,0,0,0,0,0,0,0,0,0,0,30,0,30,27,0,90,0,0,100
"37","14","1",5,6,9,3,7,10,4,3,6,6,8,4,5,3,4,18,48,56,104,23,18,22.1153846153846,17.3076923076923,53.8461538461538,46.1538461538462
"38","14","2",4,4,1,5,1,1,5,1,3,2,1,1,5,1,1,4,24,19,43,8,2,18.6046511627907,4.65116279069767,44.1860465116279,55.8139534883721
"39","14","3",21,3,3,0,3,0,0,0,4,0,0,0,0,0,0,0,33,4,37,21,0,56.7567567567568,0,10.8108108108108,89.1891891891892
"40","14","4",17,2,3,0,3,2,0,0,3,1,2,0,0,0,0,0,30,6,36,17,4,47.2222222222222,11.1111111111111,16.6666666666667,83.3333333333333
"41","14","5",26,2,2,0,2,0,0,0,3,0,0,0,0,0,0,0,35,3,38,26,0,68.4210526315789,0,7.89473684210526,92.1052631578947
"42","14","6",6,6,6,0,5,1,0,0,5,0,1,0,0,0,0,0,26,7,33,6,2,18.1818181818182,6.06060606060606,21.2121212121212,78.7878787878788
"43","15","1",22,9,10,2,10,3,1,1,9,3,3,1,1,1,1,1,59,22,81,23,6,28.3950617283951,7.40740740740741,27.1604938271605,72.8395061728395
"44","15","2",38,12,13,4,13,4,4,0,11,6,4,0,4,0,0,0,90,26,116,38,8,32.7586206896552,6.89655172413793,22.4137931034483,77.5862068965517
"45","15","3",23,9,11,2,11,5,2,2,9,4,5,2,2,2,2,4,67,31,98,27,10,27.5510204081633,10.2040816326531,31.6326530612245,68.3673469387755
"46","15","4",20,10,6,6,6,16,4,4,11,2,16,2,6,2,4,1,75,44,119,21,32,17.6470588235294,26.890756302521,36.9747899159664,63.0252100840336
"47","15","5",12,9,6,10,7,5,9,4,9,7,6,3,9,4,4,6,65,48,113,18,11,15.929203539823,9.73451327433628,42.4778761061947,57.5221238938053
"48","15","6",18,7,8,3,6,3,3,4,7,4,1,4,5,2,4,5,53,34,87,23,4,26.4367816091954,4.59770114942529,39.0804597701149,60.9195402298851
"49","16","1",60,13,15,4,13,16,10,1,13,6,14,7,6,5,1,0,135,52,187,60,30,32.0855614973262,16.0427807486631,27.807486631016,72.192513368984
"50","16","2",124,6,5,1,5,0,1,0,6,0,0,0,1,0,0,0,145,7,152,124,0,81.5789473684211,0,4.60526315789474,95.3947368421053
"51","16","3",128,1,1,0,1,0,0,0,1,0,0,0,0,0,0,0,134,1,135,128,0,94.8148148148148,0,0.740740740740741,99.2592592592593
"52","16","4",70,10,10,0,9,6,0,0,9,0,6,0,0,0,0,0,107,16,123,70,12,56.9105691056911,9.75609756097561,13.0081300813008,86.9918699186992
"53","16","5",73,5,4,1,4,0,1,0,5,0,0,0,1,0,0,0,91,6,97,73,0,75.2577319587629,0,6.18556701030928,93.8144329896907
"54","16","6",64,2,3,0,3,0,0,0,2,1,0,0,0,0,0,0,75,3,78,64,0,82.0512820512821,0,3.84615384615385,96.1538461538462
"55","17","1",54,15,18,1,16,3,2,0,14,4,2,1,2,0,0,0,111,24,135,54,5,40,3.7037037037037,17.7777777777778,82.2222222222222
"56","17","2",54,3,1,2,1,0,3,0,4,0,0,1,3,0,0,0,67,8,75,54,0,72,0,10.6666666666667,89.3333333333333
"57","17","3",30,2,1,1,2,1,1,0,2,0,2,0,0,1,0,0,41,5,46,30,3,65.2173913043478,6.52173913043478,10.8695652173913,89.1304347826087
"58","17","4",21,3,3,1,4,4,1,0,3,2,4,0,1,0,0,0,39,11,50,21,8,42,16,22,78
"59","17","5",26,3,3,0,3,0,1,0,3,1,0,0,1,0,0,0,38,6,44,26,0,59.0909090909091,0,13.6363636363636,86.3636363636364
"60","17","6",20,0,0,0,0,0,0,0,0,0,0,0,0,0,0,0,23,0,23,20,0,86.9565217391304,0,0,100
"61","18","1",1,2,2,1,2,6,2,5,2,1,6,6,1,6,5,18,22,47,69,19,12,27.536231884058,17.3913043478261,68.1159420289855,31.8840579710145
"62","18","2",1,1,5,2,4,9,2,7,1,6,9,7,3,7,8,26,33,68,101,27,18,26.7326732673267,17.8217821782178,67.3267326732673,32.6732673267327
"63","18","3",2,3,3,9,7,11,9,7,3,9,15,7,5,11,8,15,52,75,127,17,26,13.3858267716535,20.4724409448819,59.0551181102362,40.9448818897638
"64","18","4",72,14,15,3,14,7,5,1,15,4,6,3,5,1,1,0,134,35,169,72,13,42.603550295858,7.69230769230769,20.7100591715976,79.2899408284024
"65","18","5",162,6,6,0,6,0,0,0,6,0,0,0,0,0,0,0,183,6,189,162,0,85.7142857142857,0,3.17460317460317,96.8253968253968
"66","18","6",121,3,4,0,4,0,0,0,4,0,0,0,0,0,0,0,135,4,139,121,0,87.0503597122302,0,2.87769784172662,97.1223021582734
"67","19","1",12,10,10,6,12,10,1,5,9,7,12,0,4,2,5,0,68,40,108,12,22,11.1111111111111,20.3703703703704,37.037037037037,62.962962962963
"68","19","2",10,10,13,8,12,13,11,4,10,10,12,8,8,7,4,3,82,64,146,13,25,8.9041095890411,17.1232876712329,43.8356164383562,56.1643835616438
"69","19","3",17,10,12,4,9,7,8,4,10,6,4,8,7,4,4,7,72,52,124,24,11,19.3548387096774,8.87096774193548,41.9354838709677,58.0645161290323
"70","19","4",20,9,12,6,12,7,6,3,9,8,7,3,5,4,3,2,76,43,119,22,14,18.4873949579832,11.7647058823529,36.1344537815126,63.8655462184874
"71","19","5",8,6,3,7,5,2,6,2,6,4,4,1,5,3,2,0,40,27,67,8,6,11.9402985074627,8.95522388059701,40.2985074626866,59.7014925373134
"72","19","6",2,3,2,3,2,2,1,5,3,2,1,3,3,3,5,4,21,26,47,6,3,12.7659574468085,6.38297872340426,55.3191489361702,44.6808510638298
"73","2","1",30,6,6,5,6,13,5,10,6,5,13,10,5,11,10,24,82,86,168,54,26,32.1428571428571,15.4761904761905,51.1904761904762,48.8095238095238
"74","2","2",0,0,0,0,0,2,1,14,0,0,2,15,0,14,14,94,18,141,159,94,4,59.1194968553459,2.51572327044025,88.6792452830189,11.3207547169811
"75","2","3",0,0,0,0,0,1,0,8,0,0,1,8,0,8,8,56,9,84,93,56,2,60.2150537634409,2.1505376344086,90.3225806451613,9.67741935483871
"76","2","4",0,0,0,0,0,1,1,5,0,0,1,6,0,6,5,44,7,65,72,44,2,61.1111111111111,2.77777777777778,90.2777777777778,9.72222222222222
"77","2","5",0,0,0,0,0,0,0,2,0,0,0,3,0,3,3,44,3,55,58,44,0,75.8620689655172,0,94.8275862068966,5.17241379310345
"78","2","6",0,0,0,0,0,0,0,2,0,0,0,2,0,2,2,51,2,60,62,51,0,82.258064516129,0,96.7741935483871,3.2258064516129
"79","20","1",5,5,5,3,5,5,4,4,5,3,5,5,2,5,3,30,36,61,97,35,10,36.0824742268041,10.3092783505155,62.8865979381443,37.1134020618557
"80","20","2",0,0,0,0,0,0,0,0,0,0,0,0,0,0,0,54,0,57,57,54,0,94.7368421052632,0,100,0
"81","20","3",0,0,0,0,0,0,0,1,0,0,0,1,0,2,2,49,2,56,58,49,0,84.4827586206897,0,96.551724137931,3.44827586206897
"82","20","4",4,3,7,2,4,5,3,5,3,6,2,6,5,3,6,10,34,43,77,14,7,18.1818181818182,9.09090909090909,55.8441558441558,44.1558441558442
"83","20","5",9,3,1,2,2,5,2,5,3,0,6,6,1,7,5,43,30,73,103,52,11,50.4854368932039,10.6796116504854,70.873786407767,29.126213592233
"84","20","6",2,1,1,2,3,7,4,6,1,2,9,8,0,10,6,3,27,41,68,5,16,7.35294117647059,23.5294117647059,60.2941176470588,39.7058823529412
"85","21","1",4,2,2,4,3,7,5,6,2,4,8,6,3,8,6,8,34,47,81,12,15,14.8148148148148,18.5185185185185,58.0246913580247,41.9753086419753
"86","21","2",1,1,3,5,3,7,3,6,1,7,7,5,4,5,6,11,30,48,78,12,14,15.3846153846154,17.9487179487179,61.5384615384615,38.4615384615385
"87","21","3",2,2,6,3,4,8,4,2,2,6,7,3,4,2,2,4,33,31,64,6,15,9.375,23.4375,48.4375,51.5625
"88","21","4",3,2,3,3,4,5,4,1,2,3,6,2,1,3,1,1,26,21,47,4,11,8.51063829787234,23.4042553191489,44.6808510638298,55.3191489361702
"89","21","5",0,3,4,4,7,2,2,3,3,5,6,1,1,4,3,3,27,27,54,3,8,5.55555555555556,14.8148148148148,50,50
"90","21","6",8,2,1,1,0,1,1,2,2,0,0,2,2,1,2,4,18,14,32,12,1,37.5,3.125,43.75,56.25
"91","22","1",0,0,0,0,0,0,0,1,0,0,0,1,0,0,0,0,1,4,5,0,0,0,0,80,20
"92","22","2",0,0,1,0,0,2,0,1,0,1,1,1,0,0,0,1,4,7,11,1,3,9.09090909090909,27.2727272727273,63.6363636363636,36.3636363636364
"93","22","3",0,0,0,0,0,3,0,0,0,0,3,0,0,1,1,6,4,13,17,6,6,35.2941176470588,35.2941176470588,76.4705882352941,23.5294117647059
"94","22","4",1,1,1,1,1,3,1,1,1,1,3,0,1,1,1,1,11,11,22,2,6,9.09090909090909,27.2727272727273,50,50
"95","22","5",0,1,1,1,2,1,0,1,1,1,2,0,0,0,0,0,7,7,14,0,3,0,21.4285714285714,50,50
"96","22","6",0,1,0,1,1,1,2,3,1,0,2,4,0,5,3,3,10,20,30,3,3,10,10,66.6666666666667,33.3333333333333
"97","23","1",17,28,37,10,32,64,14,15,28,20,59,19,16,14,15,6,219,178,397,23,123,5.79345088161209,30.9823677581864,44.8362720403023,55.1637279596977
"98","23","2",22,34,50,10,48,95,16,5,34,26,93,11,12,9,5,1,282,192,474,23,188,4.85232067510549,39.662447257384,40.5063291139241,59.4936708860759
"99","23","3",20,33,50,7,41,117,17,7,32,24,108,17,16,8,7,1,294,214,508,21,225,4.13385826771654,44.2913385826772,42.1259842519685,57.8740157480315
"100","23","4",12,20,29,10,19,89,21,10,21,19,78,21,21,10,10,5,213,185,398,17,167,4.2713567839196,41.9597989949749,46.4824120603015,53.5175879396985
"101","23","5",11,17,30,11,23,66,22,7,17,25,59,18,19,11,8,1,189,159,348,12,125,3.44827586206897,35.9195402298851,45.6896551724138,54.3103448275862
"102","23","6",14,19,36,6,29,63,13,2,19,23,56,9,13,2,2,0,183,126,309,14,119,4.53074433656958,38.5113268608414,40.7766990291262,59.2233009708738
"103","24","1",5,2,2,1,2,0,1,1,2,2,0,0,2,0,1,1,16,9,25,6,0,24,0,36,64
"104","24","2",2,3,2,3,1,1,0,5,2,2,0,2,3,1,5,4,18,21,39,6,1,15.3846153846154,2.56410256410256,53.8461538461538,46.1538461538462
"105","24","3",4,6,6,1,4,3,3,0,6,1,1,2,2,0,0,0,28,14,42,4,4,9.52380952380952,9.52380952380952,33.3333333333333,66.6666666666667
"106","24","4",0,1,2,0,2,0,0,0,1,1,0,0,0,0,0,0,7,3,10,0,0,0,0,30,70
"107","24","5",3,1,1,0,1,0,0,0,0,0,0,0,0,0,0,0,8,1,9,3,0,33.3333333333333,0,11.1111111111111,88.8888888888889
"108","24","6",1,0,0,0,0,0,0,0,0,0,0,0,0,0,0,0,4,0,4,1,0,25,0,0,100
"109","25","1",0,0,1,2,0,2,0,9,0,2,1,7,2,6,8,105,14,134,148,105,3,70.945945945946,2.02702702702703,90.5405405405405,9.45945945945946
"110","25","2",0,0,0,3,0,0,0,9,0,3,0,6,3,6,9,192,12,222,234,192,0,82.0512820512821,0,94.8717948717949,5.12820512820513
"111","25","3",0,0,0,5,1,1,5,12,0,5,2,12,4,13,13,111,25,162,187,111,3,59.3582887700535,1.60427807486631,86.6310160427807,13.3689839572193
"112","25","4",12,10,9,7,12,5,3,9,9,6,8,5,3,9,9,14,68,65,133,26,13,19.5488721804511,9.77443609022556,48.8721804511278,51.1278195488722
"113","25","5",12,5,3,6,4,4,3,9,5,4,5,6,5,6,8,8,46,50,96,20,9,20.8333333333333,9.375,52.0833333333333,47.9166666666667
"114","25","6",17,5,8,5,8,3,6,3,5,8,4,3,5,4,3,7,57,40,97,24,7,24.7422680412371,7.21649484536082,41.2371134020619,58.7628865979381
"115","26","1",6,2,2,1,2,2,1,4,1,2,2,4,1,4,4,5,22,24,46,11,4,23.9130434782609,8.69565217391304,52.1739130434783,47.8260869565217
"116","26","2",1,4,6,0,5,4,3,4,4,2,3,6,2,5,4,2,29,29,58,3,7,5.17241379310345,12.0689655172414,50,50
"117","26","3",24,9,7,3,9,4,4,1,10,1,5,2,2,3,1,0,64,24,88,24,9,27.2727272727273,10.2272727272727,27.2727272727273,72.7272727272727
"118","26","4",22,10,14,1,13,6,3,0,10,5,5,2,2,1,0,0,72,25,97,22,11,22.680412371134,11.340206185567,25.7731958762887,74.2268041237113
"119","26","5",17,5,4,0,4,3,0,0,5,0,3,0,0,0,0,0,35,9,44,17,6,38.6363636363636,13.6363636363636,20.4545454545455,79.5454545454545
"120","26","6",5,4,5,1,5,3,2,0,4,2,3,1,1,1,0,0,28,12,40,5,6,12.5,15,30,70
"121","27","1",9,7,9,3,11,7,5,6,8,5,8,8,2,9,6,18,60,64,124,27,15,21.7741935483871,12.0967741935484,51.6129032258064,48.3870967741936
"122","27","2",14,11,9,6,9,9,4,6,11,4,9,4,5,5,6,7,69,53,122,21,18,17.2131147540984,14.7540983606557,43.4426229508197,56.5573770491803
"123","27","3",19,9,5,8,5,4,6,8,9,4,4,6,7,6,8,5,65,51,116,24,8,20.6896551724138,6.89655172413793,43.9655172413793,56.0344827586207
"124","27","4",52,11,9,5,9,3,5,2,11,3,3,2,5,2,2,1,99,29,128,53,6,41.40625,4.6875,22.65625,77.34375
"125","27","5",69,7,7,1,7,2,1,0,8,1,2,0,1,0,0,0,97,12,109,69,4,63.302752293578,3.6697247706422,11.0091743119266,88.9908256880734
"126","27","6",43,11,12,2,12,2,2,0,11,3,2,0,2,0,0,0,87,18,105,43,4,40.9523809523809,3.80952380952381,17.1428571428571,82.8571428571429
"127","28","1",13,13,7,9,10,6,7,6,13,3,10,4,6,7,6,2,73,52,125,15,16,12,12.8,41.6,58.4
"128","28","2",16,5,6,1,4,8,4,0,5,2,5,3,3,1,0,0,45,21,66,16,13,24.2424242424242,19.6969696969697,31.8181818181818,68.1818181818182
"129","28","3",0,2,2,2,4,8,1,3,2,2,10,2,1,3,3,5,24,29,53,5,18,9.43396226415094,33.9622641509434,54.7169811320755,45.2830188679245
"130","28","4",1,1,3,0,2,4,1,0,0,2,3,1,0,1,0,0,13,9,22,1,7,4.54545454545455,31.8181818181818,40.9090909090909,59.0909090909091
"131","28","5",1,1,2,1,3,2,2,0,1,2,3,1,0,2,0,0,14,10,24,1,5,4.16666666666667,20.8333333333333,41.6666666666667,58.3333333333333
"132","28","6",8,4,3,2,4,0,2,0,4,1,1,0,1,0,0,0,24,9,33,8,1,24.2424242424242,3.03030303030303,27.2727272727273,72.7272727272727
"133","29","1",0,0,0,0,0,0,0,0,0,0,0,0,0,0,0,0,0,0,0,0,0,NA,NA,NA,NA
"134","29","2",0,0,0,0,0,0,0,0,0,0,0,0,0,0,0,0,1,1,2,0,0,0,0,50,50
"135","29","3",0,0,0,1,0,2,3,1,0,1,2,3,1,3,1,2,8,15,23,2,4,8.69565217391304,17.3913043478261,65.2173913043478,34.7826086956522
"136","29","4",0,0,1,0,0,4,1,0,0,1,3,1,1,1,1,0,7,10,17,0,7,0,41.1764705882353,58.8235294117647,41.1764705882353
"137","29","5",1,1,3,0,2,9,1,0,1,1,8,1,0,1,0,0,18,14,32,1,17,3.125,53.125,43.75,56.25
"138","29","6",0,0,0,0,0,3,0,0,0,0,2,0,0,0,0,0,4,4,8,0,5,0,62.5,50,50
"139","3","1",7,7,6,5,7,6,7,2,7,4,7,4,4,5,2,0,49,34,83,7,13,8.43373493975904,15.6626506024096,40.9638554216867,59.0361445783133
"140","3","2",4,2,4,1,2,3,3,0,2,3,1,2,2,1,0,0,20,13,33,4,4,12.1212121212121,12.1212121212121,39.3939393939394,60.6060606060606
"141","3","3",1,1,1,3,1,1,3,1,1,2,1,1,2,2,1,0,13,12,25,1,2,4,8,48,52
"142","3","4",1,1,0,1,1,2,1,0,1,0,3,0,0,1,0,0,9,6,15,1,5,6.66666666666667,33.3333333333333,40,60
"143","3","5",13,1,0,1,0,0,0,1,1,0,0,0,0,0,1,0,17,4,21,13,0,61.9047619047619,0,19.047619047619,80.9523809523809
"144","3","6",2,0,0,0,0,0,0,0,0,0,0,0,0,0,0,0,5,0,5,2,0,40,0,0,100
"145","30","1",5,3,3,3,4,0,2,1,4,3,1,0,2,1,1,3,24,15,39,8,1,20.5128205128205,2.56410256410256,38.4615384615385,61.5384615384615
"146","30","2",7,5,3,4,4,4,3,4,5,2,5,3,3,4,4,18,35,46,81,25,9,30.8641975308642,11.1111111111111,56.7901234567901,43.2098765432099
"147","30","3",0,0,1,4,1,4,2,7,0,5,4,4,4,4,6,11,19,41,60,11,8,18.3333333333333,13.3333333333333,68.3333333333333,31.6666666666667
"148","30","4",0,0,0,2,0,0,1,2,0,2,0,1,2,1,2,9,6,19,25,9,0,36,0,76,24
"149","30","5",0,2,2,2,3,2,1,2,2,2,2,1,1,1,1,1,14,14,28,1,4,3.57142857142857,14.2857142857143,50,50
"150","30","6",0,0,0,1,0,0,1,3,0,1,0,2,1,3,3,4,6,16,22,4,0,18.1818181818182,0,72.7272727272727,27.2727272727273
"151","31","1",1,1,0,1,0,0,3,1,1,0,0,2,1,2,0,22,7,31,38,23,0,60.5263157894737,0,81.5789473684211,18.4210526315789
"152","31","2",0,0,1,0,0,3,0,6,0,1,2,6,0,5,5,40,10,62,72,40,5,55.5555555555556,6.94444444444444,86.1111111111111,13.8888888888889
"153","31","3",0,0,1,0,1,3,0,4,0,1,3,4,0,4,4,46,9,65,74,46,6,62.1621621621622,8.10810810810811,87.8378378378378,12.1621621621622
"154","31","4",0,1,0,3,0,0,2,2,1,2,0,1,4,1,3,18,10,31,41,18,0,43.9024390243902,0,75.609756097561,24.390243902439
"155","31","5",0,0,0,0,0,0,0,2,0,0,0,2,0,2,3,15,3,24,27,15,0,55.5555555555556,0,88.8888888888889,11.1111111111111
"156","31","6",0,0,0,1,0,0,2,1,0,1,0,2,1,2,2,14,5,24,29,14,0,48.2758620689655,0,82.7586206896552,17.2413793103448
"157","32","1",0,0,1,1,0,2,0,7,0,2,1,6,2,5,7,78,11,104,115,78,3,67.8260869565217,2.60869565217391,90.4347826086957,9.56521739130435
"158","32","2",3,2,2,3,1,7,2,11,2,3,6,9,4,8,10,40,31,85,116,43,13,37.0689655172414,11.2068965517241,73.2758620689655,26.7241379310345
"159","32","3",4,2,5,4,6,8,4,6,2,7,9,6,3,7,7,15,40,58,98,19,17,19.3877551020408,17.3469387755102,59.1836734693878,40.8163265306122
"160","32","4",4,2,5,3,6,2,3,2,2,6,2,2,2,2,1,7,27,27,54,11,4,20.3703703703704,7.40740740740741,50,50
"161","32","5",0,1,0,1,1,1,2,1,1,1,1,2,1,2,1,1,9,11,20,1,2,5,10,55,45
"162","32","6",0,0,0,0,0,5,1,1,0,0,5,2,0,1,0,3,7,14,21,3,10,14.2857142857143,47.6190476190476,66.6666666666667,33.3333333333333
"163","33","1",0,1,1,5,1,2,7,7,1,5,1,9,5,8,6,11,24,49,73,11,3,15.0684931506849,4.10958904109589,67.1232876712329,32.8767123287671
"164","33","2",1,1,1,3,3,7,3,8,1,3,10,8,1,11,9,17,29,61,90,18,17,20,18.8888888888889,67.7777777777778,32.2222222222222
"165","33","3",0,0,0,1,0,3,1,6,0,1,3,6,1,6,6,47,11,73,84,47,6,55.9523809523809,7.14285714285714,86.9047619047619,13.0952380952381
"166","33","4",0,0,0,0,0,1,0,4,0,0,1,4,0,4,4,32,5,48,53,32,2,60.377358490566,3.77358490566038,90.5660377358491,9.43396226415094
"167","33","5",0,0,0,1,0,0,0,3,0,1,0,2,1,2,3,50,4,62,66,50,0,75.7575757575758,0,93.9393939393939,6.06060606060606
"168","33","6",0,0,0,0,0,3,0,1,0,0,3,1,0,1,1,34,4,43,47,34,6,72.3404255319149,12.7659574468085,91.4893617021277,8.51063829787234
"169","34","1",2,1,0,1,1,0,1,0,1,0,0,0,0,0,0,0,7,3,10,2,0,20,0,30,70
"170","34","2",4,0,0,0,0,0,0,0,0,0,0,0,0,0,0,0,7,0,7,4,0,57.1428571428571,0,0,100
"171","34","3",2,1,0,1,0,0,3,0,2,0,0,1,2,1,0,0,10,6,16,2,0,12.5,0,37.5,62.5
"172","34","4",11,2,2,0,2,0,0,0,2,0,0,0,0,0,0,0,20,2,22,11,0,50,0,9.09090909090909,90.9090909090909
"173","34","5",5,1,1,0,1,0,0,0,1,0,0,0,0,0,0,0,11,1,12,5,0,41.6666666666667,0,8.33333333333333,91.6666666666667
"174","34","6",1,1,2,0,1,0,0,0,1,0,0,0,0,0,0,0,7,2,9,1,0,11.1111111111111,0,22.2222222222222,77.7777777777778
"175","35","1",26,6,4,5,8,2,3,3,7,3,6,1,2,5,4,4,60,32,92,30,8,32.6086956521739,8.69565217391304,34.7826086956522,65.2173913043478
"176","35","2",132,3,2,1,2,0,1,0,3,0,0,0,1,0,0,0,144,4,148,132,0,89.1891891891892,0,2.7027027027027,97.2972972972973
"177","35","3",66,8,7,0,7,2,0,0,7,0,2,0,0,0,0,0,92,10,102,66,4,64.7058823529412,3.92156862745098,9.80392156862745,90.1960784313726
"178","35","4",14,1,1,1,1,0,0,0,0,1,0,0,0,0,0,0,19,3,22,14,0,63.6363636363636,0,13.6363636363636,86.3636363636364
"179","35","5",22,3,5,0,5,1,0,0,3,2,1,0,0,0,0,0,39,6,45,22,2,48.8888888888889,4.44444444444444,13.3333333333333,86.6666666666667
"180","35","6",5,5,3,2,3,1,2,0,4,0,1,0,1,0,0,0,22,8,30,5,2,16.6666666666667,6.66666666666667,26.6666666666667,73.3333333333333
"181","36","1",4,5,6,8,4,7,7,8,4,9,6,7,9,6,8,21,51,71,122,25,13,20.4918032786885,10.655737704918,58.1967213114754,41.8032786885246
"182","36","2",20,9,10,4,13,1,1,3,10,5,3,0,2,2,3,2,64,27,91,22,4,24.1758241758242,4.3956043956044,29.6703296703297,70.3296703296703
"183","36","3",12,6,8,1,7,6,1,1,6,3,5,1,2,0,1,0,44,19,63,12,11,19.047619047619,17.4603174603175,30.1587301587302,69.8412698412698
"184","36","4",0,0,1,0,0,1,0,0,0,0,0,0,0,0,0,0,3,2,5,0,1,0,20,40,60
"185","36","5",0,2,2,2,2,1,1,1,2,2,1,0,2,0,1,0,13,9,22,0,2,0,9.09090909090909,40.9090909090909,59.0909090909091
"186","36","6",9,2,3,0,2,5,1,0,2,1,5,1,1,0,0,0,24,11,35,9,10,25.7142857142857,28.5714285714286,31.4285714285714,68.5714285714286
"187","37","1",0,0,0,0,0,1,1,1,0,0,1,2,0,2,2,5,4,14,18,5,2,27.7777777777778,11.1111111111111,77.7777777777778,22.2222222222222
"188","37","2",1,1,1,1,2,5,0,3,2,1,6,2,1,3,4,1,17,20,37,2,11,5.40540540540541,29.7297297297297,54.0540540540541,45.9459459459459
"189","37","3",6,6,6,3,4,5,5,2,6,3,2,4,5,2,2,0,38,26,64,6,7,9.375,10.9375,40.625,59.375
"190","37","4",19,5,6,0,5,7,0,0,4,1,7,0,0,0,0,0,44,13,57,19,14,33.3333333333333,24.5614035087719,22.8070175438597,77.1929824561404
"191","37","5",24,5,4,1,5,4,1,0,5,0,5,0,0,1,0,0,47,11,58,24,9,41.3793103448276,15.5172413793103,18.9655172413793,81.0344827586207
"192","37","6",4,3,3,0,2,4,1,1,2,0,3,2,0,1,1,0,19,11,30,4,7,13.3333333333333,23.3333333333333,36.6666666666667,63.3333333333333
"193","38","1",0,0,0,0,1,0,0,0,0,1,1,0,0,1,0,0,3,4,7,0,1,0,14.2857142857143,57.1428571428571,42.8571428571429
"194","38","2",0,0,0,2,0,0,1,1,0,1,0,0,1,0,0,0,4,5,9,0,0,0,0,55.5555555555556,44.4444444444444
"195","38","3",0,0,0,0,1,0,0,0,0,0,0,0,0,0,0,0,3,1,4,0,0,0,0,25,75
"196","38","4",0,0,0,0,0,0,0,0,0,0,0,0,0,0,0,0,3,0,3,0,0,0,0,0,100
"197","38","5",0,0,0,0,0,0,0,0,0,0,0,0,0,0,0,0,1,1,2,0,0,0,0,50,50
"198","38","6",0,0,0,0,0,0,0,0,0,0,0,0,0,1,0,0,1,3,4,0,0,0,0,75,25
"199","39","1",44,11,17,2,19,1,2,0,11,8,2,0,1,1,0,0,98,24,122,44,3,36.0655737704918,2.45901639344262,19.672131147541,80.327868852459
"200","39","2",54,10,11,1,9,3,2,1,10,1,1,2,2,0,1,0,92,19,111,54,4,48.6486486486486,3.6036036036036,17.1171171171171,82.8828828828829
"201","39","3",29,9,11,5,13,5,7,2,10,7,7,4,4,5,2,2,84,41,125,31,12,24.8,9.6,32.8,67.2
"202","39","4",48,10,12,2,11,3,2,1,9,4,2,2,2,1,1,0,90,23,113,48,5,42.4778761061947,4.42477876106195,20.353982300885,79.646017699115
"203","39","5",46,11,8,6,8,4,6,1,11,2,5,1,5,2,1,1,92,29,121,47,9,38.8429752066116,7.43801652892562,23.9669421487603,76.0330578512397
"204","39","6",33,7,8,0,8,0,0,0,7,1,0,0,0,0,0,0,59,8,67,33,0,49.2537313432836,0,11.9402985074627,88.0597014925373
"205","40","1",1,2,4,3,6,3,5,2,2,5,5,4,1,7,2,2,27,30,57,3,8,5.26315789473684,14.0350877192982,52.6315789473684,47.3684210526316
"206","40","2",14,4,4,1,4,0,0,1,4,1,0,0,1,0,1,0,31,7,38,14,0,36.8421052631579,0,18.4210526315789,81.5789473684211
"207","40","3",13,4,4,1,4,2,2,1,4,1,2,2,1,2,1,0,33,14,47,13,4,27.6595744680851,8.51063829787234,29.7872340425532,70.2127659574468
"208","40","4",13,2,2,0,2,1,1,0,3,0,1,1,1,0,0,0,24,6,30,13,2,43.3333333333333,6.66666666666667,20,80
"209","40","5",7,2,2,0,2,1,0,0,2,0,1,0,0,0,0,0,17,3,20,7,2,35,10,15,85
"210","40","6",0,1,1,1,1,0,0,1,2,0,0,0,1,0,1,0,8,4,12,0,0,0,0,33.3333333333333,66.6666666666667
"211","41","1",2,3,3,5,5,3,1,5,3,5,5,1,2,3,4,11,27,37,64,13,8,20.3125,12.5,57.8125,42.1875
"212","41","2",4,1,1,2,1,2,2,3,1,2,2,2,2,3,3,5,17,22,39,9,4,23.0769230769231,10.2564102564103,56.4102564102564,43.5897435897436
"213","41","3",0,1,1,0,1,1,1,1,1,0,1,2,1,1,1,1,8,9,17,1,2,5.88235294117647,11.7647058823529,52.9411764705882,47.0588235294118
"214","41","4",1,0,0,0,0,0,1,0,1,0,0,0,1,0,0,0,5,2,7,1,0,14.2857142857143,0,28.5714285714286,71.4285714285714
"215","41","5",0,0,0,0,0,0,0,0,0,0,0,0,0,0,0,0,1,1,2,0,0,0,0,50,50
"216","41","6",0,0,0,0,0,0,0,0,0,0,0,0,0,0,0,0,1,0,1,0,0,0,0,0,100
"217","42","1",2,7,9,6,6,15,13,8,7,8,12,15,9,11,8,2,67,74,141,4,27,2.83687943262411,19.1489361702128,52.4822695035461,47.5177304964539
"218","42","2",1,3,1,5,2,3,4,6,3,3,4,5,5,6,7,12,27,46,73,13,7,17.8082191780822,9.58904109589041,63.013698630137,36.986301369863
"219","42","3",0,0,0,0,0,2,0,0,0,0,3,0,0,0,0,0,4,4,8,0,5,0,62.5,50,50
"220","42","4",0,0,0,0,0,0,0,0,0,0,0,0,0,0,0,0,0,2,2,0,0,0,0,100,0
"221","42","5",0,0,0,0,0,0,0,0,0,0,0,0,0,0,0,0,0,0,0,0,0,NA,NA,NA,NA
"222","42","6",0,0,0,0,0,0,0,0,0,0,0,0,0,0,0,0,0,0,0,0,0,NA,NA,NA,NA
"223","43","1",17,3,2,4,2,1,5,0,3,2,1,1,3,1,0,0,35,13,48,17,2,35.4166666666667,4.16666666666667,27.0833333333333,72.9166666666667
"224","43","2",3,3,7,2,8,10,3,0,3,7,11,1,1,2,0,0,38,26,64,3,21,4.6875,32.8125,40.625,59.375
"225","43","3",0,0,1,0,0,0,0,0,0,0,0,0,0,0,0,0,3,1,4,0,0,0,0,25,75
"226","43","4",18,1,1,0,1,0,0,0,1,0,0,0,0,0,0,0,24,1,25,18,0,72,0,4,96
"227","43","5",11,3,3,0,2,1,1,0,3,0,0,1,1,0,0,0,24,5,29,11,1,37.9310344827586,3.44827586206897,17.2413793103448,82.7586206896552
"228","43","6",39,3,3,0,3,0,0,0,3,0,0,0,0,0,0,0,51,3,54,39,0,72.2222222222222,0,5.55555555555556,94.4444444444444
"229","44","1",2,4,6,4,4,12,9,8,4,6,9,13,6,11,8,5,50,64,114,7,21,6.14035087719298,18.4210526315789,56.140350877193,43.859649122807
"230","44","2",7,5,4,5,2,18,7,8,5,5,15,10,8,7,8,11,58,70,128,18,33,14.0625,25.78125,54.6875,45.3125
"231","44","3",4,5,8,4,7,12,3,5,5,7,12,4,5,4,5,8,50,51,101,12,24,11.8811881188119,23.7623762376238,50.4950495049505,49.5049504950495
"232","44","4",11,8,8,4,6,9,8,3,9,4,7,6,7,4,3,1,60,41,101,12,16,11.8811881188119,15.8415841584158,40.5940594059406,59.4059405940594
"233","44","5",8,6,8,2,8,7,1,2,6,4,7,0,2,0,2,2,43,25,68,10,14,14.7058823529412,20.5882352941176,36.7647058823529,63.2352941176471
"234","44","6",15,8,11,2,11,6,5,1,9,5,5,4,3,3,1,0,62,30,92,15,11,16.304347826087,11.9565217391304,32.6086956521739,67.3913043478261
"235","45","1",3,3,4,9,8,5,5,6,2,10,9,2,4,7,6,7,44,49,93,10,14,10.752688172043,15.0537634408602,52.6881720430108,47.3118279569892
"236","45","2",5,3,1,6,2,6,7,9,3,4,6,10,5,10,8,19,39,68,107,24,12,22.4299065420561,11.214953271028,63.5514018691589,36.4485981308411
"237","45","3",0,0,1,1,1,3,1,8,0,2,3,8,1,7,7,27,15,58,73,27,6,36.986301369863,8.21917808219178,79.4520547945205,20.5479452054795
"238","45","4",0,0,2,1,1,6,3,4,0,3,5,7,2,6,5,22,18,52,70,22,11,31.4285714285714,15.7142857142857,74.2857142857143,25.7142857142857
"239","45","5",0,1,0,1,0,0,1,3,1,0,0,3,1,3,3,8,6,22,28,8,0,28.5714285714286,0,78.5714285714286,21.4285714285714
"240","45","6",0,0,1,2,1,4,1,1,0,3,4,0,2,1,1,5,11,18,29,5,8,17.2413793103448,27.5862068965517,62.0689655172414,37.9310344827586
"241","46","1",1,1,3,1,2,3,2,1,1,4,2,2,3,1,1,1,16,16,32,2,5,6.25,15.625,50,50
"242","46","2",0,1,0,1,0,0,2,0,1,0,0,0,1,1,0,0,5,5,10,0,0,0,0,50,50
"243","46","3",4,2,5,0,5,1,1,0,3,2,1,1,0,1,0,0,21,8,29,4,2,13.7931034482759,6.89655172413793,27.5862068965517,72.4137931034483
"244","46","4",6,8,6,3,5,6,5,2,7,1,6,4,3,4,2,2,43,30,73,8,12,10.958904109589,16.4383561643836,41.0958904109589,58.9041095890411
"245","46","5",19,5,3,1,3,2,0,1,4,0,2,0,1,0,1,1,36,10,46,20,4,43.4782608695652,8.69565217391304,21.7391304347826,78.2608695652174
"246","46","6",11,1,0,1,0,0,1,0,1,0,0,0,1,0,0,0,17,2,19,11,0,57.8947368421053,0,10.5263157894737,89.4736842105263
"247","47","1",16,11,7,5,5,4,4,6,10,2,2,5,7,3,6,5,60,41,101,21,6,20.7920792079208,5.94059405940594,40.5940594059406,59.4059405940594
"248","47","2",4,6,7,8,6,7,8,5,6,9,6,5,9,3,5,15,52,60,112,19,13,16.9642857142857,11.6071428571429,53.5714285714286,46.4285714285714
"249","47","3",0,1,3,3,3,3,3,8,1,5,3,8,3,9,9,9,25,49,74,9,6,12.1621621621622,8.10810810810811,66.2162162162162,33.7837837837838
"250","47","4",0,0,0,1,0,2,1,3,0,2,2,3,2,3,4,13,9,30,39,13,4,33.3333333333333,10.2564102564103,76.9230769230769,23.0769230769231
"251","47","5",1,2,3,1,2,2,2,1,2,2,1,3,2,2,2,6,15,22,37,7,3,18.9189189189189,8.10810810810811,59.4594594594595,40.5405405405405
"252","47","6",0,1,1,2,2,1,2,2,1,2,2,2,1,3,2,3,13,17,30,3,3,10,10,56.6666666666667,43.3333333333333
"253","48","1",5,1,2,0,3,7,1,0,1,1,8,1,0,2,0,0,21,14,35,5,15,14.2857142857143,42.8571428571429,40,60
"254","48","2",28,6,5,2,5,5,1,3,5,1,5,2,2,2,3,4,57,25,82,32,10,39.0243902439024,12.1951219512195,30.4878048780488,69.5121951219512
"255","48","3",4,4,5,0,4,7,2,1,3,1,7,3,0,3,1,1,29,20,49,5,14,10.2040816326531,28.5714285714286,40.8163265306122,59.1836734693878
"256","48","4",8,7,8,2,7,8,3,1,7,2,8,2,2,2,1,0,46,25,71,8,16,11.2676056338028,22.5352112676056,35.2112676056338,64.7887323943662
"257","48","5",23,5,4,4,2,5,3,6,5,2,3,6,5,4,6,6,53,39,92,29,8,31.5217391304348,8.69565217391304,42.3913043478261,57.6086956521739
"258","48","6",2,3,5,2,4,9,4,1,3,4,7,3,3,2,1,0,31,25,56,2,16,3.57142857142857,28.5714285714286,44.6428571428571,55.3571428571429
"259","49","1",0,0,0,0,0,0,0,0,0,0,1,0,0,0,0,0,2,2,4,0,1,0,25,50,50
"260","49","2",2,3,1,3,1,1,4,1,3,1,1,2,3,2,1,1,18,15,33,3,2,9.09090909090909,6.06060606060606,45.4545454545455,54.5454545454545
"261","49","3",0,2,0,7,0,1,4,4,1,5,1,2,6,2,4,5,19,28,47,5,2,10.6382978723404,4.25531914893617,59.5744680851064,40.4255319148936
"262","49","4",0,1,1,5,1,1,10,5,1,5,1,10,6,9,5,12,26,50,76,12,2,15.7894736842105,2.63157894736842,65.7894736842105,34.2105263157895
"263","49","5",0,0,1,1,1,1,1,2,0,2,1,1,1,2,2,3,8,14,22,3,2,13.6363636363636,9.09090909090909,63.6363636363636,36.3636363636364
"264","49","6",1,2,4,3,3,4,2,6,2,5,4,5,3,5,6,5,27,36,63,6,8,9.52380952380952,12.6984126984127,57.1428571428571,42.8571428571429
"265","5","1",2,1,1,0,1,0,0,0,2,0,0,0,1,0,0,0,8,3,11,2,0,18.1818181818182,0,27.2727272727273,72.7272727272727
"266","5","2",2,0,1,0,1,0,0,0,1,0,0,0,0,0,0,0,7,1,8,2,0,25,0,12.5,87.5
"267","5","3",27,2,1,1,1,0,1,0,2,0,0,0,1,0,0,0,36,3,39,27,0,69.2307692307692,0,7.69230769230769,92.3076923076923
"268","5","4",63,3,3,0,3,0,0,0,3,0,0,0,0,0,0,0,75,3,78,63,0,80.7692307692308,0,3.84615384615385,96.1538461538462
"269","5","5",77,2,2,0,2,0,0,0,3,0,0,0,0,0,0,0,86,3,89,77,0,86.5168539325843,0,3.37078651685393,96.6292134831461
"270","5","6",75,1,1,0,1,0,0,0,1,0,0,0,0,0,0,0,81,1,82,75,0,91.4634146341463,0,1.21951219512195,98.780487804878
"271","51","1",3,5,3,6,3,13,4,11,5,4,13,10,6,10,12,19,49,81,130,22,26,16.9230769230769,20,62.3076923076923,37.6923076923077
"272","51","2",0,2,1,4,2,6,8,10,2,3,7,14,3,14,9,71,33,126,159,71,13,44.6540880503145,8.17610062893082,79.2452830188679,20.7547169811321
"273","51","3",0,0,0,0,0,0,0,5,0,0,0,5,0,5,5,144,5,162,167,144,0,86.2275449101796,0,97.0059880239521,2.9940119760479
"274","51","4",0,0,0,0,0,0,0,1,0,0,0,1,0,1,1,155,1,161,162,155,0,95.679012345679,0,99.3827160493827,0.617283950617284
"275","51","5",0,0,0,0,0,0,0,0,0,0,0,0,0,0,0,144,0,147,147,144,0,97.9591836734694,0,100,0
"276","51","6",0,0,0,0,0,0,0,5,0,0,0,5,0,5,5,134,5,152,157,134,0,85.3503184713376,0,96.8152866242038,3.18471337579618
"277","52","1",0,0,0,0,0,3,0,3,0,0,3,2,0,2,2,4,6,16,22,4,6,18.1818181818182,27.2727272727273,72.7272727272727,27.2727272727273
"278","52","2",0,0,0,1,1,2,1,1,0,1,3,1,0,2,1,2,7,12,19,2,5,10.5263157894737,26.3157894736842,63.1578947368421,36.8421052631579
"279","52","3",1,1,1,0,0,1,1,0,1,0,0,1,1,1,1,13,6,20,26,14,1,53.8461538461538,3.84615384615385,76.9230769230769,23.0769230769231
"280","52","4",0,0,0,0,0,6,1,4,0,0,6,6,0,6,4,18,12,42,54,18,12,33.3333333333333,22.2222222222222,77.7777777777778,22.2222222222222
"281","52","5",0,0,0,0,0,17,1,15,0,0,18,16,0,17,15,23,35,90,125,23,35,18.4,28,72,28
"282","52","6",0,0,2,1,1,2,1,14,0,3,1,14,2,13,14,63,21,113,134,63,3,47.0149253731343,2.23880597014925,84.3283582089552,15.6716417910448
"283","53","1",15,4,4,3,7,4,1,4,5,2,7,2,0,5,4,6,45,31,76,21,11,27.6315789473684,14.4736842105263,40.7894736842105,59.2105263157895
"284","53","2",22,10,10,1,10,5,1,0,9,1,5,1,0,1,0,0,60,19,79,22,10,27.8481012658228,12.6582278481013,24.0506329113924,75.9493670886076
"285","53","3",16,6,11,1,11,1,1,1,7,5,1,1,1,1,1,0,51,17,68,16,2,23.5294117647059,2.94117647058824,25,75
"286","53","4",32,5,4,0,4,0,0,0,4,0,0,0,0,0,0,0,47,5,52,32,0,61.5384615384615,0,9.61538461538461,90.3846153846154
"287","53","5",17,3,2,1,2,0,1,0,3,0,0,0,1,0,0,0,29,4,33,17,0,51.5151515151515,0,12.1212121212121,87.8787878787879
"288","53","6",2,3,5,0,4,1,0,0,3,2,1,0,0,0,0,0,17,7,24,2,2,8.33333333333333,8.33333333333333,29.1666666666667,70.8333333333333
"289","54","1",3,4,6,2,6,3,1,4,4,4,4,3,2,3,4,2,31,27,58,5,7,8.62068965517241,12.0689655172414,46.551724137931,53.448275862069
"290","54","2",10,5,6,2,5,7,5,1,5,3,6,4,3,2,0,8,41,34,75,18,13,24,17.3333333333333,45.3333333333333,54.6666666666667
"291","54","3",1,2,2,3,2,4,5,6,3,3,4,8,4,8,6,29,28,65,93,30,8,32.258064516129,8.60215053763441,69.8924731182796,30.1075268817204
"292","54","4",0,1,2,2,1,3,1,7,1,3,2,6,3,5,6,22,17,51,68,22,5,32.3529411764706,7.35294117647059,75,25
"293","54","5",0,0,0,2,1,2,0,5,0,2,3,2,1,3,4,40,10,58,68,40,5,58.8235294117647,7.35294117647059,85.2941176470588,14.7058823529412
"294","54","6",0,0,0,1,0,0,1,6,0,1,0,6,1,5,5,21,8,42,50,21,0,42,0,84,16
"295","55","1",12,11,8,8,11,9,8,6,12,5,12,6,6,9,6,2,76,58,134,14,21,10.4477611940299,15.6716417910448,43.2835820895522,56.7164179104478
"296","55","2",11,8,6,10,8,5,10,8,7,8,7,8,7,10,8,24,67,81,148,35,12,23.6486486486486,8.10810810810811,54.7297297297297,45.2702702702703
"297","55","3",1,1,2,4,0,9,3,16,1,5,7,15,6,13,16,60,36,126,162,61,16,37.6543209876543,9.87654320987654,77.7777777777778,22.2222222222222
"298","55","4",0,1,0,2,0,0,0,8,1,1,0,7,2,7,9,162,12,191,203,162,0,79.8029556650246,0,94.0886699507389,5.91133004926108
"299","55","5",0,0,0,2,1,4,1,8,0,1,5,7,0,9,8,91,17,123,140,91,9,65,6.42857142857143,87.8571428571429,12.1428571428571
"300","55","6",0,0,1,3,2,4,3,10,0,4,5,10,2,11,10,42,23,87,110,42,9,38.1818181818182,8.18181818181818,79.0909090909091,20.9090909090909
"301","56","1",1,1,2,0,1,5,0,1,0,1,4,2,0,1,1,2,12,13,25,3,9,12,36,52,48
"302","56","2",0,0,0,0,0,1,0,2,0,0,1,2,0,2,1,2,3,11,14,2,2,14.2857142857143,14.2857142857143,78.5714285714286,21.4285714285714
"303","56","3",0,1,1,1,1,1,2,2,1,1,0,3,1,2,2,2,10,14,24,2,1,8.33333333333333,4.16666666666667,58.3333333333333,41.6666666666667
"304","56","4",0,1,1,2,0,1,1,2,1,1,0,2,2,1,2,0,9,11,20,0,1,0,5,55,45
"305","56","5",0,0,0,0,0,0,0,0,0,0,0,1,0,1,0,0,1,4,5,0,0,0,0,80,20
"306","56","6",0,0,0,0,0,0,0,0,0,0,0,0,0,0,0,0,2,1,3,0,0,0,0,33.3333333333333,66.6666666666667
"307","57","1",24,9,10,5,10,9,8,0,9,6,10,3,5,3,0,0,77,37,114,24,19,21.0526315789474,16.6666666666667,32.4561403508772,67.5438596491228
"308","57","2",4,2,3,1,3,5,1,1,2,2,5,2,1,2,2,2,21,20,41,6,10,14.6341463414634,24.390243902439,48.780487804878,51.219512195122
"309","57","3",5,4,0,4,1,1,3,1,3,0,2,0,3,1,1,2,21,13,34,7,3,20.5882352941176,8.82352941176471,38.2352941176471,61.7647058823529
"310","57","4",5,2,2,1,1,8,0,2,1,1,8,1,1,1,2,0,23,16,39,5,16,12.8205128205128,41.025641025641,41.025641025641,58.974358974359
"311","57","5",0,2,3,3,3,0,3,1,1,4,1,1,2,2,1,0,17,13,30,0,1,0,3.33333333333333,43.3333333333333,56.6666666666667
"312","57","6",2,3,3,0,4,10,0,0,4,0,11,0,0,0,0,0,25,15,40,2,21,5,52.5,37.5,62.5
"313","58","1",58,12,12,0,12,6,0,0,12,0,6,0,0,0,0,0,103,18,121,58,12,47.9338842975207,9.91735537190083,14.8760330578512,85.1239669421488
"314","58","2",153,0,0,0,0,0,0,0,0,0,0,0,0,0,0,0,156,0,156,153,0,98.0769230769231,0,0,100
"315","58","3",147,2,2,0,2,0,0,0,2,0,0,0,0,0,0,0,156,2,158,147,0,93.0379746835443,0,1.26582278481013,98.7341772151899
"316","58","4",122,2,2,0,2,0,0,0,2,0,0,0,0,0,0,0,131,2,133,122,0,91.7293233082707,0,1.50375939849624,98.4962406015038
"317","58","5",95,0,0,0,0,0,0,0,0,0,0,0,0,0,0,0,98,0,98,95,0,96.9387755102041,0,0,100
"318","58","6",42,3,2,1,2,1,1,0,3,0,1,0,1,0,0,0,55,5,60,42,2,70,3.33333333333333,8.33333333333333,91.6666666666667
"319","59","1",4,4,6,4,3,6,5,3,4,6,3,5,7,2,3,3,36,35,71,7,9,9.85915492957746,12.6760563380282,49.2957746478873,50.7042253521127
"320","59","2",4,2,3,5,3,5,3,6,1,6,5,4,4,5,6,10,32,43,75,14,10,18.6666666666667,13.3333333333333,57.3333333333333,42.6666666666667
"321","59","3",0,0,0,0,0,1,0,6,0,0,1,5,0,5,5,21,7,40,47,21,2,44.6808510638298,4.25531914893617,85.1063829787234,14.8936170212766
"322","59","4",0,0,0,0,0,6,2,2,0,0,6,5,0,5,2,4,11,24,35,4,12,11.4285714285714,34.2857142857143,68.5714285714286,31.4285714285714
"323","59","5",0,0,1,1,1,4,1,1,0,1,4,1,0,2,1,1,10,12,22,1,8,4.54545454545455,36.3636363636364,54.5454545454545,45.4545454545455
"324","59","6",0,1,1,1,1,2,2,2,1,1,3,2,1,3,2,3,12,17,29,3,5,10.3448275862069,17.2413793103448,58.6206896551724,41.3793103448276
"325","6","1",12,7,9,2,6,14,1,6,7,4,11,5,4,3,6,2,58,44,102,14,25,13.7254901960784,24.5098039215686,43.1372549019608,56.8627450980392
"326","6","2",29,7,7,3,7,18,6,2,8,3,18,5,4,4,2,2,82,46,128,31,36,24.21875,28.125,35.9375,64.0625
"327","6","3",81,10,9,3,9,1,3,0,11,1,1,0,3,0,0,0,119,16,135,81,2,60,1.48148148148148,11.8518518518519,88.1481481481482
"328","6","4",56,8,9,2,9,1,2,0,8,3,1,0,2,0,0,0,90,14,104,56,2,53.8461538461538,1.92307692307692,13.4615384615385,86.5384615384615
"329","6","5",30,10,11,3,8,6,5,0,10,3,3,2,5,0,0,0,74,25,99,30,9,30.3030303030303,9.09090909090909,25.2525252525253,74.7474747474748
"330","6","6",15,12,11,2,11,9,2,0,12,1,9,0,2,0,0,0,64,25,89,15,18,16.8539325842697,20.2247191011236,28.0898876404494,71.9101123595506
"331","60","1",1,1,1,1,1,0,0,1,1,0,1,0,0,1,1,2,8,7,15,3,1,20,6.66666666666667,46.6666666666667,53.3333333333333
"332","60","2",0,0,1,1,0,1,1,1,0,2,0,1,1,1,1,2,6,10,16,2,1,12.5,6.25,62.5,37.5
"333","60","3",0,0,0,0,0,0,0,1,0,1,0,1,1,1,2,0,3,7,10,0,0,0,0,70,30
"334","60","4",0,0,0,1,1,0,1,0,0,1,1,1,0,2,0,0,4,7,11,0,1,0,9.09090909090909,63.6363636363636,36.3636363636364
"335","60","5",0,0,0,0,0,0,0,0,0,0,0,0,0,0,0,0,0,0,0,0,0,NA,NA,NA,NA
"336","60","6",0,0,1,1,0,1,2,0,1,1,0,1,2,0,0,0,8,5,13,0,1,0,7.69230769230769,38.4615384615385,61.5384615384615
"337","62","1",6,9,10,5,8,7,5,8,9,7,5,8,7,6,8,5,60,56,116,11,12,9.48275862068965,10.3448275862069,48.2758620689655,51.7241379310345
"338","62","2",10,8,10,2,10,11,3,2,8,4,12,2,2,3,2,3,58,37,95,13,23,13.6842105263158,24.2105263157895,38.9473684210526,61.0526315789474
"339","62","3",0,2,3,1,5,10,1,3,2,2,11,3,0,4,3,3,27,29,56,3,21,5.35714285714286,37.5,51.7857142857143,48.2142857142857
"340","62","4",0,2,4,4,5,13,6,1,2,7,14,3,4,4,1,0,37,36,73,0,27,0,36.986301369863,49.3150684931507,50.6849315068493
"341","62","5",1,1,0,2,2,11,4,1,2,1,12,3,1,4,1,0,25,24,49,1,23,2.04081632653061,46.9387755102041,48.9795918367347,51.0204081632653
"342","62","6",0,2,5,1,6,19,3,0,2,4,20,2,1,2,0,0,38,32,70,0,39,0,55.7142857142857,45.7142857142857,54.2857142857143
"343","63","1",6,7,3,7,4,8,9,6,8,3,9,8,7,9,6,2,53,52,105,8,17,7.61904761904762,16.1904761904762,49.5238095238095,50.4761904761905
"344","63","2",2,5,6,8,8,7,12,6,5,9,9,10,6,12,6,8,56,66,122,10,16,8.19672131147541,13.1147540983607,54.0983606557377,45.9016393442623
"345","63","3",7,5,1,6,3,2,8,4,5,2,4,7,4,8,4,0,37,36,73,7,6,9.58904109589041,8.21917808219178,49.3150684931507,50.6849315068493
"346","63","4",0,0,1,1,2,6,2,3,0,2,8,4,0,6,3,1,17,25,42,1,14,2.38095238095238,33.3333333333333,59.5238095238095,40.4761904761905
"347","63","5",1,4,6,1,4,3,2,2,3,4,1,3,3,1,2,11,25,29,54,12,4,22.2222222222222,7.40740740740741,53.7037037037037,46.2962962962963
"348","63","6",9,6,2,4,2,2,0,4,5,0,2,1,3,1,4,2,30,20,50,11,4,22,8,40,60
"349","64","1",0,0,1,0,1,1,1,4,0,2,1,4,1,4,4,29,10,46,56,29,2,51.7857142857143,3.57142857142857,82.1428571428571,17.8571428571429
"350","64","2",0,0,4,2,1,8,2,8,0,6,5,8,5,5,7,34,25,73,98,34,13,34.6938775510204,13.265306122449,74.4897959183673,25.5102040816327
"351","64","3",5,4,6,1,5,12,3,5,4,3,11,7,2,6,5,11,42,51,93,16,23,17.2043010752688,24.7311827956989,54.8387096774194,45.1612903225806
"352","64","4",1,2,1,3,1,2,7,7,2,2,2,10,3,10,6,23,24,61,85,24,4,28.2352941176471,4.70588235294118,71.7647058823529,28.2352941176471
"353","64","5",0,2,2,2,1,1,4,5,2,2,0,7,3,6,5,22,17,50,67,22,1,32.8358208955224,1.49253731343284,74.6268656716418,25.3731343283582
"354","64","6",1,1,2,2,2,4,3,8,1,3,4,9,2,9,7,22,23,60,83,23,8,27.710843373494,9.63855421686747,72.289156626506,27.710843373494
"355","65","1",6,4,5,12,8,2,5,9,4,13,5,2,9,6,9,7,52,57,109,13,7,11.9266055045872,6.42201834862385,52.2935779816514,47.7064220183486
"356","65","2",28,9,10,6,8,7,6,2,9,7,5,2,8,0,2,0,79,33,112,28,12,25,10.7142857142857,29.4642857142857,70.5357142857143
"357","65","3",19,9,6,6,7,3,7,0,10,3,3,1,6,1,0,0,60,24,84,19,6,22.6190476190476,7.14285714285714,28.5714285714286,71.4285714285714
"358","65","4",7,5,10,2,7,6,5,1,4,7,4,4,4,2,1,2,45,29,74,9,10,12.1621621621622,13.5135135135135,39.1891891891892,60.8108108108108
"359","65","5",3,5,5,6,7,4,2,6,6,6,6,2,4,4,6,1,41,35,76,4,10,5.26315789473684,13.1578947368421,46.0526315789474,53.9473684210526
"360","65","6",15,6,6,5,4,7,6,4,6,5,4,5,7,2,4,3,54,38,92,18,11,19.5652173913043,11.9565217391304,41.304347826087,58.695652173913
"361","66","1",4,5,3,4,2,1,2,5,4,2,1,3,4,3,5,5,28,28,56,9,2,16.0714285714286,3.57142857142857,50,50
"362","66","2",2,2,1,3,2,2,2,5,2,2,3,4,3,5,6,17,21,43,64,19,5,29.6875,7.8125,67.1875,32.8125
"363","66","3",2,1,2,3,2,6,1,3,1,3,6,2,2,2,3,6,21,27,48,8,12,16.6666666666667,25,56.25,43.75
"364","66","4",0,0,0,1,1,1,0,2,0,1,1,1,1,1,2,2,7,10,17,2,2,11.7647058823529,11.7647058823529,58.8235294117647,41.1764705882353
"365","66","5",0,1,0,3,1,4,3,2,1,2,5,1,2,2,2,2,15,19,34,2,9,5.88235294117647,26.4705882352941,55.8823529411765,44.1176470588235
"366","66","6",0,0,1,0,0,2,3,5,0,1,1,8,1,7,5,21,11,47,58,21,3,36.2068965517241,5.17241379310345,81.0344827586207,18.9655172413793
"367","67","1",7,5,5,6,6,6,4,10,5,5,7,9,4,10,10,13,50,65,115,20,13,17.3913043478261,11.304347826087,56.5217391304348,43.4782608695652
"368","67","2",1,2,6,7,5,11,4,11,2,11,10,9,7,8,11,18,48,78,126,19,21,15.0793650793651,16.6666666666667,61.9047619047619,38.0952380952381
"369","67","3",6,7,3,9,5,6,9,6,7,5,8,6,7,8,6,9,52,58,110,15,14,13.6363636363636,12.7272727272727,52.7272727272727,47.2727272727273
"370","67","4",3,4,4,4,4,9,4,7,3,4,10,7,3,8,7,13,41,56,97,16,19,16.4948453608247,19.5876288659794,57.7319587628866,42.2680412371134
"371","67","5",6,6,6,4,5,5,4,6,6,5,4,6,6,4,6,3,44,41,85,9,9,10.5882352941176,10.5882352941176,48.2352941176471,51.7647058823529
"372","67","6",14,8,6,6,8,2,4,2,8,5,4,0,5,2,2,0,52,27,79,14,6,17.7215189873418,7.59493670886076,34.1772151898734,65.8227848101266
"373","68","1",5,7,8,6,8,10,14,9,7,7,10,17,6,17,9,10,69,84,153,15,20,9.80392156862745,13.0718954248366,54.9019607843137,45.0980392156863
"374","68","2",19,11,9,8,13,8,8,6,10,6,12,6,3,10,5,6,82,61,143,25,20,17.4825174825175,13.986013986014,42.6573426573427,57.3426573426573
"375","68","3",9,10,9,8,8,5,10,4,10,7,4,5,9,4,4,4,64,49,113,13,9,11.5044247787611,7.9646017699115,43.3628318584071,56.6371681415929
"376","68","4",1,4,5,2,3,3,3,0,3,3,1,2,3,0,0,0,22,14,36,1,4,2.77777777777778,11.1111111111111,38.8888888888889,61.1111111111111
"377","68","5",0,0,1,0,0,3,2,3,0,1,2,4,1,4,3,4,10,21,31,4,5,12.9032258064516,16.1290322580645,67.741935483871,32.258064516129
"378","68","6",0,0,0,4,2,1,1,5,0,3,3,2,1,4,4,6,13,26,39,6,4,15.3846153846154,10.2564102564103,66.6666666666667,33.3333333333333
"379","69","1",49,6,4,6,3,6,8,4,7,4,5,6,8,5,5,3,89,43,132,52,11,39.3939393939394,8.33333333333333,32.5757575757576,67.4242424242424
"380","69","2",78,7,7,0,7,2,1,1,8,0,2,2,0,2,1,1,106,16,122,79,4,64.7540983606557,3.27868852459016,13.1147540983607,86.8852459016394
"381","69","3",65,2,2,0,2,0,0,0,2,0,0,0,0,0,0,0,74,2,76,65,0,85.5263157894737,0,2.63157894736842,97.3684210526316
"382","69","4",0,0,0,0,0,0,0,0,0,0,0,0,0,0,0,0,0,0,0,0,0,NA,NA,NA,NA
"383","69","5",0,0,0,0,0,0,0,0,0,0,0,0,0,0,0,0,0,0,0,0,0,NA,NA,NA,NA
"384","69","6",0,0,0,0,0,0,0,0,0,0,0,0,0,0,0,0,0,0,0,0,0,NA,NA,NA,NA
"385","7","1",9,7,10,8,14,28,7,5,7,11,32,4,4,8,5,3,90,75,165,12,60,7.27272727272727,36.3636363636364,45.4545454545455,54.5454545454545
"386","7","2",1,3,4,4,6,9,3,1,3,5,11,1,2,2,1,0,32,27,59,1,20,1.69491525423729,33.8983050847458,45.7627118644068,54.2372881355932
"387","7","3",28,9,9,0,9,4,0,0,9,0,4,0,0,0,0,0,62,13,75,28,8,37.3333333333333,10.6666666666667,17.3333333333333,82.6666666666667
"388","7","4",1,2,4,2,4,5,2,1,1,4,5,1,1,1,0,0,21,16,37,1,10,2.7027027027027,27.027027027027,43.2432432432432,56.7567567567568
"389","7","5",0,0,1,1,0,1,1,1,0,1,0,1,1,0,0,0,5,6,11,0,1,0,9.09090909090909,54.5454545454545,45.4545454545455
"390","7","6",0,0,0,0,0,0,1,0,0,0,0,1,0,1,1,2,2,7,9,2,0,22.2222222222222,0,77.7777777777778,22.2222222222222
"391","70","1",43,8,10,0,8,6,2,1,8,2,5,3,2,2,1,3,80,27,107,46,11,42.9906542056075,10.2803738317757,25.2336448598131,74.7663551401869
"392","70","2",15,7,6,1,7,0,1,0,6,0,1,0,0,1,0,0,39,9,48,15,1,31.25,2.08333333333333,18.75,81.25
"393","70","3",4,2,1,1,2,2,1,0,2,0,3,0,0,1,0,0,16,6,22,4,5,18.1818181818182,22.7272727272727,27.2727272727273,72.7272727272727
"394","70","4",0,0,0,0,0,0,0,0,0,0,0,0,0,0,0,0,0,0,0,0,0,NA,NA,NA,NA
"395","70","5",0,0,0,0,0,0,0,0,0,0,0,0,0,0,0,0,0,0,0,0,0,NA,NA,NA,NA
"396","70","6",0,0,0,0,0,0,0,0,0,0,0,0,0,0,0,0,0,0,0,0,0,NA,NA,NA,NA
"397","71","1",28,8,9,1,7,8,5,2,8,3,6,6,4,3,2,0,70,33,103,28,14,27.1844660194175,13.5922330097087,32.0388349514563,67.9611650485437
"398","71","2",26,5,6,0,6,1,0,0,5,1,1,0,0,0,0,0,47,7,54,26,2,48.1481481481481,3.7037037037037,12.962962962963,87.037037037037
"399","71","3",2,3,2,2,4,7,4,0,3,2,8,2,1,3,0,0,26,20,46,2,15,4.34782608695652,32.6086956521739,43.4782608695652,56.5217391304348
"400","71","4",0,0,0,0,0,0,0,0,0,0,0,0,0,0,0,0,0,0,0,0,0,NA,NA,NA,NA
"401","71","5",0,0,0,0,0,0,0,0,0,0,0,0,0,0,0,0,0,0,0,0,0,NA,NA,NA,NA
"402","71","6",0,0,0,0,0,0,0,0,0,0,0,0,0,0,0,0,0,0,0,0,0,NA,NA,NA,NA
"403","72","1",10,9,7,10,8,6,7,8,9,8,8,5,9,7,8,5,67,60,127,15,14,11.8110236220472,11.0236220472441,47.244094488189,52.755905511811
"404","72","2",1,6,5,7,1,10,14,9,6,6,7,15,11,12,9,11,55,78,133,12,17,9.02255639097744,12.781954887218,58.6466165413534,41.3533834586466
"405","72","3",2,1,4,1,4,10,4,0,2,4,10,3,2,2,0,0,29,23,52,2,20,3.84615384615385,38.4615384615385,44.2307692307692,55.7692307692308
"406","72","4",0,0,0,0,0,0,0,0,0,0,0,0,0,0,0,0,0,0,0,0,0,NA,NA,NA,NA
"407","72","5",0,0,0,0,0,0,0,0,0,0,0,0,0,0,0,0,0,0,0,0,0,NA,NA,NA,NA
"408","72","6",0,0,0,0,0,0,0,0,0,0,0,0,0,0,0,0,0,0,0,0,0,NA,NA,NA,NA
"409","73","1",10,6,5,6,5,4,7,2,6,5,4,3,7,3,2,0,47,31,78,10,8,12.8205128205128,10.2564102564103,39.7435897435897,60.2564102564103
"410","73","2",20,4,5,0,4,2,1,0,3,1,1,1,1,0,0,0,38,8,46,20,3,43.4782608695652,6.52173913043478,17.3913043478261,82.6086956521739
"411","73","3",2,2,1,1,2,1,2,0,1,0,2,1,0,2,0,0,13,7,20,2,3,10,15,35,65
"412","73","4",0,0,0,0,0,0,0,0,0,0,0,0,0,0,0,0,0,0,0,0,0,NA,NA,NA,NA
"413","73","5",0,0,0,0,0,0,0,0,0,0,0,0,0,0,0,0,0,0,0,0,0,NA,NA,NA,NA
"414","73","6",0,0,0,0,0,0,0,0,0,0,0,0,0,0,0,0,0,0,0,0,0,NA,NA,NA,NA
"415","74","1",10,6,7,7,6,5,5,8,6,7,4,6,7,5,7,7,54,52,106,17,9,16.0377358490566,8.49056603773585,49.0566037735849,50.9433962264151
"416","74","2",0,0,1,3,1,4,3,5,0,4,4,5,3,5,6,17,18,46,64,17,8,26.5625,12.5,71.875,28.125
"417","74","3",0,2,2,2,3,1,1,2,1,2,2,1,0,2,1,1,13,13,26,1,3,3.84615384615385,11.5384615384615,50,50
"418","74","4",0,0,0,0,0,0,0,0,0,0,0,0,0,0,0,0,0,0,0,0,0,NA,NA,NA,NA
"419","74","5",0,0,0,0,0,0,0,0,0,0,0,0,0,0,0,0,0,0,0,0,0,NA,NA,NA,NA
"420","74","6",0,0,0,0,0,0,0,0,0,0,0,0,0,0,0,0,0,0,0,0,0,NA,NA,NA,NA
"421","75","1",0,0,0,0,1,3,1,0,0,0,4,0,0,1,0,0,7,6,13,0,7,0,53.8461538461538,46.1538461538462,53.8461538461538
"422","75","2",41,8,7,2,8,0,2,0,8,1,2,0,1,1,0,0,70,14,84,41,2,48.8095238095238,2.38095238095238,16.6666666666667,83.3333333333333
"423","75","3",5,3,5,2,5,5,2,0,3,4,5,0,2,0,0,0,30,14,44,5,10,11.3636363636364,22.7272727272727,31.8181818181818,68.1818181818182
"424","75","4",0,0,0,0,0,0,0,0,0,0,0,0,0,0,0,0,0,0,0,0,0,NA,NA,NA,NA
"425","75","5",0,0,0,0,0,0,0,0,0,0,0,0,0,0,0,0,0,0,0,0,0,NA,NA,NA,NA
"426","75","6",0,0,0,0,0,0,0,0,0,0,0,0,0,0,0,0,0,0,0,0,0,NA,NA,NA,NA
"427","76","1",98,10,10,2,11,8,2,0,11,2,8,0,2,0,0,0,144,23,167,98,16,58.6826347305389,9.58083832335329,13.7724550898204,86.2275449101796
"428","76","2",161,4,4,0,4,0,0,0,4,0,0,0,0,0,0,0,176,4,180,161,0,89.4444444444444,0,2.22222222222222,97.7777777777778
"429","76","3",64,3,1,1,1,0,1,0,2,0,0,0,1,0,0,0,73,4,77,64,0,83.1168831168831,0,5.19480519480519,94.8051948051948
"430","76","4",0,0,0,0,0,0,0,0,0,0,0,0,0,0,0,0,0,0,0,0,0,NA,NA,NA,NA
"431","76","5",0,0,0,0,0,0,0,0,0,0,0,0,0,0,0,0,0,0,0,0,0,NA,NA,NA,NA
"432","76","6",0,0,0,0,0,0,0,0,0,0,0,0,0,0,0,0,0,0,0,0,0,NA,NA,NA,NA
"433","77","1",2,1,2,1,2,0,1,0,1,2,0,0,2,0,0,0,11,6,17,2,0,11.7647058823529,0,35.2941176470588,64.7058823529412
"434","77","2",0,0,0,0,0,1,0,1,0,1,1,1,1,1,1,5,4,12,16,5,2,31.25,12.5,75,25
"435","77","3",0,0,0,0,0,3,0,1,0,0,3,1,0,2,2,1,5,11,16,1,6,6.25,37.5,68.75,31.25
"436","77","4",0,0,0,0,0,0,0,0,0,0,0,0,0,0,0,0,0,0,0,0,0,NA,NA,NA,NA
"437","77","5",0,1,1,0,0,1,1,0,0,0,0,1,0,0,0,0,5,3,8,0,1,0,12.5,37.5,62.5
"438","77","6",0,0,0,0,0,0,0,0,0,0,0,0,0,0,0,0,1,0,1,0,0,0,0,0,100
"439","78","1",3,5,7,5,9,6,9,3,5,7,8,7,4,9,4,3,49,48,97,6,14,6.18556701030928,14.4329896907216,49.4845360824742,50.5154639175258
"440","78","2",4,3,5,1,7,3,2,1,3,4,5,1,0,3,1,2,28,20,48,6,8,12.5,16.6666666666667,41.6666666666667,58.3333333333333
"441","78","3",0,1,2,2,4,3,1,1,1,2,5,0,0,2,1,3,16,15,31,3,8,9.67741935483871,25.8064516129032,48.3870967741936,51.6129032258064
"442","78","4",0,0,0,1,1,0,0,1,0,1,1,0,0,0,0,0,3,5,8,0,1,0,12.5,62.5,37.5
"443","78","5",0,0,1,0,0,5,1,0,0,1,5,1,1,1,1,0,9,11,20,0,10,0,50,55,45
"444","78","6",1,1,1,0,1,7,0,1,2,0,6,1,1,0,1,1,15,12,27,2,13,7.40740740740741,48.1481481481481,44.4444444444444,55.5555555555556
"445","79","1",13,11,13,8,12,9,10,2,11,11,8,4,9,3,2,2,80,51,131,15,17,11.4503816793893,12.9770992366412,38.9312977099237,61.0687022900763
"446","79","2",8,8,10,2,7,22,8,2,8,4,19,9,4,6,2,3,68,57,125,11,41,8.8,32.8,45.6,54.4
"447","79","3",18,8,12,5,10,14,8,5,8,9,12,8,6,6,5,8,81,64,145,26,26,17.9310344827586,17.9310344827586,44.1379310344828,55.8620689655172
"448","79","4",29,11,9,5,9,11,5,2,10,3,12,2,4,3,2,0,83,37,120,29,23,24.1666666666667,19.1666666666667,30.8333333333333,69.1666666666667
"449","79","5",4,3,2,2,1,1,0,3,4,1,0,1,3,0,3,3,19,15,34,7,1,20.5882352941176,2.94117647058824,44.1176470588235,55.8823529411765
"450","79","6",18,5,5,1,4,4,2,0,5,1,3,2,2,0,0,0,40,15,55,18,7,32.7272727272727,12.7272727272727,27.2727272727273,72.7272727272727
"451","80","1",2,3,3,6,3,8,6,6,2,6,8,6,5,7,6,10,38,52,90,12,16,13.3333333333333,17.7777777777778,57.7777777777778,42.2222222222222
"452","80","2",4,4,5,3,4,4,1,8,4,4,3,5,4,5,8,3,34,38,72,7,7,9.72222222222222,9.72222222222222,52.7777777777778,47.2222222222222
"453","80","3",34,7,6,3,8,6,4,1,8,2,7,2,2,3,1,0,72,25,97,34,13,35.0515463917526,13.4020618556701,25.7731958762887,74.2268041237113
"454","80","4",13,5,6,2,5,5,2,4,4,3,4,4,3,3,4,1,44,27,71,14,9,19.7183098591549,12.6760563380282,38.0281690140845,61.9718309859155
"455","80","5",13,7,7,1,8,4,0,2,7,2,4,1,1,1,2,1,44,20,64,14,8,21.875,12.5,31.25,68.75
"456","80","6",11,4,6,1,4,9,4,6,3,4,7,9,3,7,6,2,47,42,89,13,16,14.6067415730337,17.9775280898876,47.1910112359551,52.8089887640449
"457","81","1",11,4,5,5,4,4,1,9,4,5,3,5,5,4,8,26,43,63,106,37,7,34.9056603773585,6.60377358490566,59.4339622641509,40.5660377358491
"458","81","2",1,2,0,2,0,0,1,6,2,0,0,5,2,4,5,10,12,31,43,11,0,25.5813953488372,0,72.0930232558139,27.906976744186
"459","81","3",0,0,1,3,0,1,3,2,0,3,0,2,3,2,2,5,11,19,30,5,1,16.6666666666667,3.33333333333333,63.3333333333333,36.6666666666667
"460","81","4",0,1,1,0,0,4,1,2,1,0,3,4,1,2,2,5,10,20,30,5,7,16.6666666666667,23.3333333333333,66.6666666666667,33.3333333333333
"461","81","5",0,1,0,2,0,0,1,1,1,0,0,0,1,0,1,3,6,8,14,3,0,21.4285714285714,0,57.1428571428571,42.8571428571429
"462","81","6",0,2,2,3,2,4,1,5,2,3,4,3,3,4,6,38,20,65,85,38,8,44.7058823529412,9.41176470588235,76.4705882352941,23.5294117647059
"463","82","1",31,10,15,1,13,8,3,0,11,6,6,2,3,0,0,0,84,28,112,31,14,27.6785714285714,12.5,25,75
"464","82","2",65,13,13,1,12,3,2,0,12,2,2,1,2,0,0,0,111,20,131,65,5,49.618320610687,3.81679389312977,15.2671755725191,84.7328244274809
"465","82","3",62,4,4,0,4,1,0,0,4,0,1,0,0,0,0,0,78,5,83,62,2,74.6987951807229,2.40963855421687,6.02409638554217,93.9759036144578
"466","82","4",19,2,2,0,2,1,0,0,2,0,1,0,0,0,0,0,29,3,32,19,2,59.375,6.25,9.375,90.625
"467","82","5",0,0,0,0,0,0,0,0,0,0,0,0,0,0,0,0,1,1,2,0,0,0,0,50,50
"468","82","6",12,1,1,0,1,0,0,0,1,0,0,0,0,0,0,0,18,1,19,12,0,63.1578947368421,0,5.26315789473684,94.7368421052632
"469","83","1",1,1,3,1,4,2,2,0,2,3,2,1,1,1,0,0,17,10,27,1,4,3.7037037037037,14.8148148148148,37.037037037037,62.962962962963
"470","83","2",0,0,1,2,0,1,3,0,0,3,0,1,2,0,0,0,8,8,16,0,1,0,6.25,50,50
"471","83","3",0,0,0,0,0,3,0,0,0,0,3,0,0,0,0,0,4,5,9,0,6,0,66.6666666666667,55.5555555555556,44.4444444444444
"472","83","4",0,0,0,0,1,0,0,0,0,1,0,0,0,0,0,0,3,2,5,0,0,0,0,40,60
"473","83","5",1,2,2,0,1,8,0,0,1,0,8,0,0,0,0,0,16,10,26,1,16,3.84615384615385,61.5384615384615,38.4615384615385,61.5384615384615
"474","83","6",0,0,0,1,1,5,1,0,0,1,6,0,0,0,0,0,9,9,18,0,11,0,61.1111111111111,50,50
"475","84","1",39,6,3,5,4,2,6,2,6,2,3,3,4,4,3,3,68,30,98,42,5,42.8571428571429,5.10204081632653,30.6122448979592,69.3877551020408
"476","84","2",14,7,6,4,4,4,6,4,6,3,2,6,5,5,4,3,50,36,86,17,6,19.7674418604651,6.97674418604651,41.8604651162791,58.1395348837209
"477","84","3",8,4,3,2,3,4,2,3,4,1,4,3,2,3,3,1,30,23,53,9,8,16.9811320754717,15.0943396226415,43.3962264150943,56.6037735849057
"478","84","4",10,7,2,5,3,1,6,1,6,0,2,3,3,4,1,0,36,21,57,10,3,17.5438596491228,5.26315789473684,36.8421052631579,63.1578947368421
"479","84","5",5,3,3,1,2,3,2,3,3,1,2,4,1,3,3,5,23,24,47,10,5,21.2765957446809,10.6382978723404,51.063829787234,48.936170212766
"480","84","6",1,2,1,3,1,1,3,5,2,2,1,5,3,5,5,8,18,33,51,9,2,17.6470588235294,3.92156862745098,64.7058823529412,35.2941176470588
"481","85","1",0,0,1,3,1,2,3,7,0,4,2,6,3,6,6,41,17,71,88,41,4,46.5909090909091,4.54545454545455,80.6818181818182,19.3181818181818
"482","85","2",0,1,1,1,1,0,0,2,1,1,0,2,1,2,3,49,7,61,68,49,0,72.0588235294118,0,89.7058823529412,10.2941176470588
"483","85","3",0,1,0,3,0,1,3,7,1,2,1,6,3,7,7,24,16,53,69,24,2,34.7826086956522,2.89855072463768,76.8115942028985,23.1884057971014
"484","85","4",0,0,3,2,4,1,3,2,0,5,2,2,1,3,2,5,16,22,38,5,3,13.1578947368421,7.89473684210526,57.8947368421053,42.1052631578947
"485","85","5",0,1,0,1,0,2,0,5,1,1,2,4,2,4,5,13,11,33,44,13,4,29.5454545454545,9.09090909090909,75,25
"486","85","6",0,0,2,1,2,1,3,2,0,3,2,4,1,5,2,5,13,23,36,5,3,13.8888888888889,8.33333333333333,63.8888888888889,36.1111111111111
"487","86","1",0,0,1,2,0,1,2,0,0,3,0,0,3,0,1,2,7,11,18,2,1,11.1111111111111,5.55555555555556,61.1111111111111,38.8888888888889
"488","86","2",0,0,0,0,0,5,1,2,0,0,4,3,0,2,2,1,9,14,23,1,9,4.34782608695652,39.1304347826087,60.8695652173913,39.1304347826087
"489","86","3",0,0,0,4,0,1,4,4,0,4,1,5,4,5,4,19,14,44,58,19,2,32.7586206896552,3.44827586206897,75.8620689655172,24.1379310344828
"490","86","4",0,2,1,3,0,1,0,6,2,2,0,2,4,1,5,18,13,37,50,18,1,36,2,74,26
"491","86","5",0,0,0,2,0,0,0,5,0,2,0,3,2,3,4,20,7,37,44,20,0,45.4545454545455,0,84.0909090909091,15.9090909090909
"492","86","6",0,0,0,1,0,1,0,7,0,1,1,6,1,5,7,13,10,36,46,13,2,28.2608695652174,4.34782608695652,78.2608695652174,21.7391304347826
"493","88","1",0,0,1,1,0,10,3,10,0,2,8,12,3,10,10,11,27,57,84,11,18,13.0952380952381,21.4285714285714,67.8571428571429,32.1428571428571
"494","88","2",1,1,1,3,1,9,5,12,1,3,9,14,3,14,13,39,34,98,132,40,18,30.3030303030303,13.6363636363636,74.2424242424242,25.7575757575758
"495","88","3",0,0,0,1,1,3,1,8,0,1,4,8,0,8,7,43,14,74,88,43,7,48.8636363636364,7.95454545454545,84.0909090909091,15.9090909090909
"496","88","4",0,0,1,2,0,2,1,6,0,3,1,5,3,4,6,17,12,42,54,17,3,31.4814814814815,5.55555555555556,77.7777777777778,22.2222222222222
"497","88","5",0,0,2,2,4,0,1,3,0,4,2,2,0,3,2,14,12,30,42,14,2,33.3333333333333,4.76190476190476,71.4285714285714,28.5714285714286
"498","88","6",0,0,0,2,0,1,1,4,0,2,1,3,2,3,4,4,8,22,30,4,2,13.3333333333333,6.66666666666667,73.3333333333333,26.6666666666667
"499","89","1",17,8,8,2,4,14,4,2,8,1,10,4,5,1,2,3,60,36,96,20,24,20.8333333333333,25,37.5,62.5
"500","89","2",45,9,12,4,11,10,6,1,9,7,8,3,5,1,1,0,99,36,135,45,18,33.3333333333333,13.3333333333333,26.6666666666667,73.3333333333333
"501","89","3",3,4,8,2,7,8,5,2,4,6,6,5,3,4,2,4,40,36,76,7,14,9.21052631578947,18.4210526315789,47.3684210526316,52.6315789473684
"502","89","4",23,4,4,2,5,2,2,0,4,3,2,0,2,0,0,0,44,12,56,23,4,41.0714285714286,7.14285714285714,21.4285714285714,78.5714285714286
"503","89","5",1,2,0,3,1,1,3,1,2,1,3,1,2,2,1,4,14,17,31,5,4,16.1290322580645,12.9032258064516,54.8387096774194,45.1612903225806
"504","89","6",0,0,0,0,0,0,0,0,0,0,0,0,0,0,0,0,1,1,2,0,0,0,0,50,50
"505","9","1",8,12,12,11,14,11,6,10,12,11,13,5,9,7,10,5,85,74,159,13,24,8.17610062893082,15.0943396226415,46.5408805031447,53.4591194968553
"506","9","2",5,5,5,5,3,3,5,8,4,5,2,8,6,7,8,31,41,72,113,36,5,31.858407079646,4.42477876106195,63.716814159292,36.283185840708
"507","9","3",3,8,11,9,12,6,6,8,7,12,7,6,7,7,8,11,64,67,131,14,13,10.6870229007634,9.9236641221374,51.1450381679389,48.8549618320611
"508","9","4",5,6,10,2,8,8,6,2,6,6,6,6,5,3,2,0,49,35,84,5,14,5.95238095238095,16.6666666666667,41.6666666666667,58.3333333333333
"509","9","5",12,4,3,6,6,3,4,3,4,5,6,1,3,4,3,0,43,27,70,12,9,17.1428571428571,12.8571428571429,38.5714285714286,61.4285714285714
"510","9","6",8,3,3,2,2,3,7,3,2,2,2,9,2,8,3,6,32,36,68,14,5,20.5882352941176,7.35294117647059,52.9411764705882,47.0588235294118
"511","90","1",11,6,8,7,8,6,9,3,6,10,6,5,8,5,4,4,60,49,109,15,12,13.7614678899083,11.0091743119266,44.954128440367,55.045871559633
"512","90","2",88,10,11,2,11,1,2,0,11,2,1,0,2,0,0,0,128,16,144,88,2,61.1111111111111,1.38888888888889,11.1111111111111,88.8888888888889
"513","90","3",66,6,6,0,6,1,0,0,6,0,1,0,0,0,0,0,88,7,95,66,2,69.4736842105263,2.10526315789474,7.36842105263158,92.6315789473684
"514","90","4",39,5,4,2,5,0,2,0,5,1,0,0,2,0,0,0,59,9,68,39,0,57.3529411764706,0,13.2352941176471,86.7647058823529
"515","90","5",14,4,6,1,6,1,1,0,3,3,1,0,1,0,0,0,35,9,44,14,2,31.8181818181818,4.54545454545455,20.4545454545455,79.5454545454545
"516","90","6",26,1,2,0,2,0,0,0,2,0,0,0,0,0,0,0,34,2,36,26,0,72.2222222222222,0,5.55555555555556,94.4444444444444
"517","91","1",2,2,6,3,4,8,4,4,2,7,6,5,5,4,4,11,34,46,80,13,14,16.25,17.5,57.5,42.5
"518","91","2",0,1,2,1,2,3,1,1,1,2,3,1,1,1,1,0,12,12,24,0,6,0,25,50,50
"519","91","3",1,1,2,0,1,1,0,0,1,1,0,0,0,0,0,0,7,4,11,1,1,9.09090909090909,9.09090909090909,36.3636363636364,63.6363636363636
"520","91","4",0,0,1,0,1,4,0,1,0,1,5,1,0,1,1,1,9,11,20,1,9,5,45,55,45
"521","91","5",2,1,1,3,0,0,3,2,1,3,0,1,4,1,2,5,14,18,32,7,0,21.875,0,56.25,43.75
"522","91","6",4,2,1,1,1,7,1,2,3,0,7,2,2,1,2,1,22,18,40,5,14,12.5,35,45,55
"523","92","1",11,7,8,4,7,10,6,3,6,6,9,5,5,4,3,2,58,41,99,13,19,13.1313131313131,19.1919191919192,41.4141414141414,58.5858585858586
"524","92","2",6,5,5,2,5,7,3,2,5,2,7,3,2,3,2,0,37,25,62,6,14,9.67741935483871,22.5806451612903,40.3225806451613,59.6774193548387
"525","92","3",0,1,1,3,1,3,2,7,1,3,3,6,3,6,7,22,20,52,72,22,6,30.5555555555556,8.33333333333333,72.2222222222222,27.7777777777778
"526","92","4",3,1,0,4,1,0,3,5,1,3,2,4,3,6,6,6,19,32,51,9,2,17.6470588235294,3.92156862745098,62.7450980392157,37.2549019607843
"527","92","5",0,1,0,2,2,3,1,5,1,2,5,4,1,6,6,30,16,56,72,30,8,41.6666666666667,11.1111111111111,77.7777777777778,22.2222222222222
"528","92","6",1,2,2,2,2,3,2,2,2,2,2,2,3,1,2,2,18,17,35,3,5,8.57142857142857,14.2857142857143,48.5714285714286,51.4285714285714
"529","93","1",4,5,8,4,7,12,6,4,5,6,11,6,4,5,3,4,50,47,97,8,23,8.24742268041237,23.7113402061856,48.4536082474227,51.5463917525773
"530","93","2",7,8,11,5,8,14,5,5,7,8,12,5,7,3,5,8,65,56,121,15,26,12.396694214876,21.4876033057851,46.2809917355372,53.7190082644628
"531","93","3",6,4,5,6,3,5,8,7,3,7,3,9,8,7,7,13,46,58,104,19,8,18.2692307692308,7.69230769230769,55.7692307692308,44.2307692307692
"532","93","4",0,0,1,5,3,8,4,7,0,6,10,6,3,7,6,10,28,51,79,10,18,12.6582278481013,22.7848101265823,64.5569620253165,35.4430379746835
"533","93","5",1,3,4,3,3,5,3,4,3,4,5,4,4,4,5,2,28,32,60,3,10,5,16.6666666666667,53.3333333333333,46.6666666666667
"534","93","6",0,0,5,2,3,17,7,3,0,7,16,8,4,6,3,0,39,45,84,0,33,0,39.2857142857143,53.5714285714286,46.4285714285714
"535","94","1",3,5,11,9,9,9,11,7,5,16,7,9,12,7,7,12,66,76,142,15,16,10.5633802816901,11.2676056338028,53.5211267605634,46.4788732394366
"536","94","2",6,5,7,8,8,10,12,5,5,10,11,10,6,11,5,7,62,67,129,13,21,10.077519379845,16.2790697674419,51.937984496124,48.062015503876
"537","94","3",1,4,4,2,2,8,6,7,4,2,6,10,4,8,6,13,34,56,90,14,14,15.5555555555556,15.5555555555556,62.2222222222222,37.7777777777778
"538","94","4",2,1,1,4,3,18,3,6,1,4,20,5,2,6,6,11,39,57,96,13,38,13.5416666666667,39.5833333333333,59.375,40.625
"539","94","5",0,0,2,1,1,4,3,4,0,3,4,6,2,6,5,4,17,31,48,4,8,8.33333333333333,16.6666666666667,64.5833333333333,35.4166666666667
"540","94","6",0,0,3,0,0,31,5,3,0,3,28,9,3,6,3,3,43,57,100,3,59,3,59,57,43
"541","95","1",0,0,1,1,0,6,2,2,0,2,5,2,2,2,2,11,13,28,41,11,11,26.8292682926829,26.8292682926829,68.2926829268293,31.7073170731707
"542","95","2",1,3,2,3,1,5,2,5,3,1,4,5,3,4,5,4,23,31,54,5,9,9.25925925925926,16.6666666666667,57.4074074074074,42.5925925925926
"543","95","3",3,1,2,0,3,3,0,1,1,1,4,1,0,2,1,4,15,15,30,7,7,23.3333333333333,23.3333333333333,50,50
"544","95","4",3,2,3,1,2,2,2,0,3,2,1,1,3,0,0,0,18,10,28,3,3,10.7142857142857,10.7142857142857,35.7142857142857,64.2857142857143
"545","95","5",2,3,3,1,4,0,1,0,3,1,1,0,0,1,0,0,17,6,23,2,1,8.69565217391304,4.34782608695652,26.0869565217391,73.9130434782609
"546","95","6",0,1,0,2,1,5,3,0,1,0,6,1,0,3,0,0,13,13,26,0,11,0,42.3076923076923,50,50
"547","96","1",9,5,6,3,6,10,2,7,5,4,10,7,3,7,7,8,49,53,102,17,20,16.6666666666667,19.6078431372549,51.9607843137255,48.0392156862745
"548","96","2",1,3,2,5,1,10,12,10,3,5,9,16,7,15,10,19,46,85,131,20,19,15.2671755725191,14.5038167938931,64.8854961832061,35.1145038167939
"549","96","3",5,4,5,2,1,7,3,9,4,3,3,9,6,5,8,11,36,52,88,16,10,18.1818181818182,11.3636363636364,59.0909090909091,40.9090909090909
"550","96","4",2,2,2,7,4,2,5,6,2,7,4,4,5,6,5,4,30,40,70,6,6,8.57142857142857,8.57142857142857,57.1428571428571,42.8571428571429
"551","96","5",1,2,1,4,0,2,2,6,2,3,1,4,5,3,6,6,18,33,51,7,3,13.7254901960784,5.88235294117647,64.7058823529412,35.2941176470588
"552","96","6",1,1,1,1,1,1,0,1,1,1,1,0,0,0,0,7,7,13,20,8,2,40,10,65,35
"553","97","1",1,2,1,2,0,7,2,3,2,2,6,3,3,2,3,3,20,25,45,4,13,8.88888888888889,28.8888888888889,55.5555555555556,44.4444444444444
"554","97","2",0,0,0,0,0,0,0,0,0,0,0,0,0,0,0,0,1,1,2,0,0,0,0,50,50
"555","97","3",0,1,2,0,2,2,0,0,0,1,2,0,0,0,0,0,9,4,13,0,4,0,30.7692307692308,30.7692307692308,69.2307692307692
"556","97","4",0,0,1,0,0,1,1,1,0,1,0,1,1,0,1,1,5,7,12,1,1,8.33333333333333,8.33333333333333,58.3333333333333,41.6666666666667
"557","97","5",1,1,1,0,1,1,0,0,1,0,1,0,0,0,0,0,8,2,10,1,2,10,20,20,80
"558","97","6",3,2,1,1,1,1,1,0,1,0,2,0,0,1,0,0,12,5,17,3,3,17.6470588235294,17.6470588235294,29.4117647058824,70.5882352941177
"559","98","1",0,2,6,6,6,13,8,10,2,10,13,12,6,12,9,31,51,98,149,31,26,20.8053691275168,17.4496644295302,65.7718120805369,34.2281879194631
"560","98","2",0,1,0,8,0,2,1,18,1,7,2,11,8,11,18,144,30,205,235,144,4,61.2765957446809,1.70212765957447,87.2340425531915,12.7659574468085
"561","98","3",0,0,0,3,0,0,0,10,0,3,0,7,3,7,9,175,13,207,220,175,0,79.5454545454545,0,94.0909090909091,5.90909090909091
"562","98","4",0,2,0,6,2,1,2,9,2,4,3,5,4,7,10,143,23,180,203,143,4,70.4433497536946,1.97044334975369,88.6699507389163,11.3300492610837
"563","98","5",0,0,0,2,0,0,0,5,0,2,0,3,2,3,5,146,7,164,171,146,0,85.3801169590643,0,95.906432748538,4.09356725146199
"564","98","6",0,0,1,5,0,2,3,9,0,6,1,8,6,7,10,100,21,140,161,100,3,62.111801242236,1.86335403726708,86.9565217391304,13.0434782608696
